OXOOXXXXOOXOXOX
XOXOXOOXXXXOOXO
OXOXOXOXOOXXXXO
XXOOXOXOXOXOOXX
OXXXXOOXOXOXOXO