XXXXXXXXXXXXXXXXXXXXXXXXXXXX
XXXXXXXXXXXXXXXXXXXXXXXXXXXX
XXSOOOXOXOXOXOXOXOXOXOXXXXXX
XXXXXXOXOXOXOXOXOXOXOXXXXXXX
XXXXXXXOXOXOXOXOXOXOXOXXXXXX
XXXXXXOXOXOXOXOXOXOXOXOOOFXX
XXXXXXXXXXXXXXXXXXXXXXXXXXXX
XXXXXXXXXXXXXXXXXXXXXXXXXXXX