XOOXXOOXOXXXXO
OOXOXXXXOXOOXX
XXXOXOOXXOOXOX
OOXXOOXOXXXXOX
OXOXXXXOXOOXXO
XXOXOOXXOOXOXX
OXXOOXOXXXXOXO
XOXXXXOXOOXXOO
XOXOOXXOOXOXXX
XXOOXOXXXXOXOO
OXXXXOXOOXXOOX
OXOOXXOOXOXXXX
XOOXOXXXXOXOOX
XXXXOXOOXXOOXO