XXXXXXXXXXXXXXXXXXXXXXXXXXXX
XXXXXXXXXXXXXXXXXXXXXXXXXXXX
XXSSOOXOXOXOXOXOXOXOXOXXXXXX
XXXXXXOXOXOXOXOXOXOXOXXXXXXX
XXXXXXXOXOXOXOXOXOXOXOXXXXXX
XXXXXXOXOXOXOXOXOXOXOXOOOFXX
XXXXXXXXXXXXXXXXXXXXXXXXXXXX
XXXXXXXXXXXXXXXXXXXXXXXXXXXX