XXOOXXOOXXOOXXOO
XOXOXOXOXOXOXOXO
OXOXOXOXOXOXOXOX
XXOOXXOOXXOOXXOO
XXXXXXXXXXXXXXXX