PXXXXXXXXXXXXXXXXXXXXXXXXXXXXXXXXXXXXXXXXXXXXXXXXXXXXXXXXXXXXXXXXXXXXXXXXXXXXXXXXXXXXXXXXXXXXXXXXXXXXXXXXXXXXXXXXXXXXXXXXXXXXXXXXXXXXXXXXXXXXXXXX
PXXXXXXXXXXXXXXXXXXXXXXXXXXXXXXXXOOOOOOOOOOOOOOOOOOOOOOOOOOOOOOOOOOOOOXXXXXXXXXXXOOOOOOOOOOOOOOOOOOOOOOOOOOOOOOOOOOOOOXXXXXXXXXXXXXXOXXXXXXXXXXXX
PXXXXXXXXXXXXXXXXXXXXXXXXXXXXXXXXOOOOOOOOOOOOOOOOOOOOOOOOOOOOOOOOOOOOOXXXXXXXXXXXOOOOOOOOOOOOOOOOOOOOOOOOOOOOOOOOOOOOOXXXXXXXXXXXXXXOXXXXXXXXXXXX
PXXOXXXXXXXXXXXXXXXXXXXXXXXOOOOOOOOOOOOOOOOOOOOOOOOOOOOOOOOOOOOOOOOOOOOOOXXXXXOOOOOOOOOOOOOOOOOOOOOOOOOOOOOOOOOOOOOOOOOOOOOXXXXXXXOOOOOXXXXXXXXXX
PXXOOOXXXXXXXXXXXXXXXXOOOOOOOOOOOOOOOOOOOOOOOOOOOOOOOOOOOOOOOOOOOOOOOOOOOOOXOOOOOOOOOOOOOOOOOOOOOOOOOOOOOOOOOOOOOOOOOOOOOOOOXXXXXOOOOOOOXXXXXXXXX
PXXOOOXXXXXXXXXXXXXXXXOOOOOOOOOOOOOOOOOOOOOOOOOOOOOOOOOOOOOOOOOOOOOOOOOOOOOXOOOOOOOOOOOOOOOOOOOOOOOOOOOOOOOOOOOOOOOOOOOOOOOOXXXXXOOOOOOOXXXXXXXXX
PXXOOOOXXXXXXXXXXXXXXOOOOOOOOOOOOOOOOOOOOOOOOOOOOOOOOOOOOOOOOOOOOOOOOOOOOXXOXXOOOOOOOOOOOOOOOOOOOOOOOOOOOOOOOOOOOOOOOOOOOOOOOOXOOOOOOOOOOOXXXXXXX
PXXOOOOOOXXXXXXXXXXOOOOOOOOOOOOOOOOOOOOXXXXXXXXXXXXXXXXXXXXXOOOOOOOOOOOOXOOXOOXOOOOOOOOXXXXXXXXXXXXXXXXXXXXXXXXXXXXOOOOOOOOOXXOXXOOOOOOOOOOXXXXXX
PXXOOOOOOXXXXXXXXXXOOOOOOOOOOOOOOOOOOOOXXXXXXXXXXXXXXXXXXXXXOOOOOOOOOOOOXOOXOOXOOOOOOOOXXXXXXXXXXXXXXXXXXXXXXXXXXXXOOOOOOOOOXXOXXOOOOOOOOOOXXXXXX
PXXOOOOOOOXXXXXXXXOOOOOOOOOOOOOOOOXXXXXXXXXXXXXXXXXXXXXXXXXXXXXXXXXOOOXXOXXOXXOXXOOOXXXXXXXXXXXXXXXXXXXXXXXXXXXXXXXXXXOOOOOXOOXOOXOOOOOOOOOOOXXXX
PXXOOOOOOOOOXXXXSSOOOOOOOOOOOOOXXXXXXXXXXXOOOOXXXOOOOOXXXXXXXXXXXXXXXXOOXOOXOOXOOXXXXXXXXXXXXXXXXXXXXXXXXXXXXXXXXXXXXXXXOXXOXXOXXOXXOOOOOOOOOOXXX
PXXOOOOOOOOOXXXXSSOOOOOOOOOOOOOXXXXXXXXXXXOOOOXXXOOOOOXXXXXXXXXXXXXXXXOOXOOXOOXOOXXXXXXXXXXXXXXXXXXXXXXXXXXXXXXXXXXXXXXXOXXOXXOXXOXXOOOOOOOOOOXXX
PXXOOOOOOOOOOXXFSSSOOOOOOOOOXXXXXXXXXXXXXXXXXOXXXOOXXXXXXXXXXXXXXXXXXOXXOXXOXXOXXOXXXXXXXXXXXXXXXXXXXXXXXXXXXXXXXXXXXXXXXOOXOOXOOXOOX11111111111X
XXXOOOOOOOOOXOOXFFSSSOOOOOOXXXXXXXXXXXXXXXXXXXOOOXXXXXXXXXXXXXXXXXXOOOOOXOOXOOXOOOOOXXXXXXXXXXXXXXXXXXXXXXXXXXXXXXXXXXXXOXXOXXOXXOXXOOOOOOOOOOXXX
XXXOOOOOOOOOXOOXFFSSSOOOOOOXXXXXXXXXXXXXXXXXXXOOOXXXXXXXXXXXXXXXXXXOOOOOXOOXOOXOOOOOXXXXXXXXXXXXXXXXXXXXXXXXXXXXXXXXXXXXOXXOXXOXXOXXOOOOOOOOOOXXX
XXXOOOOOOOXXOXXOXXFSSSOOOXXXXXXXXXXXXXXXXXXXXXOOOXXXXXXXXXXXXXXXXXOOOOOOOXXOXXOOOOOOOXXXXXXXXXXXXXXXXXXXXXXXXXXXXXXXXXOOOOOXOOXOOXOOOOOOOOOOOXXXX
XXXOOOOOOXOOXOOXOOXFFSSSXXXXXXXXXXXXXXXXXXXXXOOOOOOXXXXXXXXXXXXXOOOOOOOOOOOXOOOOOOOOOOOXXXXXXXXXXXXXXXXXXXXXXXXXXXXXXOOOOOOOXXOXXOOOOOOOOOOXXXXXX
XXXOOOOOOXOOXOOXOOXFFSSSXXXXXXXXXXXXXXXXXXXXXOOOOOOXXXXXXXXXXXXXOOOOOOOOOOOXOOOOOOOOOOOXXXXXXXXXXXXXXXXXXXXXXXXXXXXXXOOOOOOOXXOXXOOOOOOOOOOXXXXXX
XXX222222OXXOXXOXXOXXXXXXXXXXXXXXXXXXXXXXXXXXXXXXXXXXXXXXXXXXXXOOOOOOOOOOXXXXXOOOOOOOOOOOOXXXXXXXXXXXXXXXXXXXXXXXXOOOOOOOOOOOOXOOOOOOOOOOOXXXXXXX
XXXOOOOOOXOOXOOXOOXOOXXXXXXXXXXXXXXXXXXXXXXXXXXXXXXXXXXXXXXXXOOOOOOOOOOOXXXXXXXOOOOOOOOOOOOOOXXXXXXXXXXXXXXXXXXOOOOOOOOOOOOOXXXXXOOOOOOOXXXXXXXXX
XXXOOOOOOXOOXOOXOOXOOXXXXXXXXXXXXXXXXXXXXXXXXXXXXXXXXXXXXXXXXOOOOOOOOOOOXXXXXXXOOOOOOOOOOOOOOXXXXXXXXXXXXXXXXXXOOOOOOOOOOOOOXXXXXOOOOOOOXXXXXXXXX
XXXOOOOOOOXXOXXOXXOOOOXXXXXXXXXXXXXXXXXXXXXXXXXXXXXXXXXXXXOOOOOOOOOOOOXXXXXXXXXXXXOOOOOOOOOOOOOOOOOOOOOOOOOOOOOOOOOOOOOOOOOXXXXXXXOOOOOXXXXXXXXXX
XXXOOOOOOOXXOXXOXXOOOOXXXXXXXXXXXXXXXXXXXXXXXXXXXXXXXXXXXXOOOOOOOOOOOOXXXXXXXXXXXXOOOOOOOOOOOOOOOOOOOOOOOOOOOOOOOOOOOOOOOOOXXXXXXXOOOOOXXXXXXXXXX
XXXOOOOOOOOOXOOXOOOOOOOOOXXXXXXXXXXXXXXXXXXXXXXXXXXXXXOOOOOOOOOOOOOOOXXXXXXXXXXXXXXXXOOOOOOOOOOOOOOOOOOOOOOOOOOOOOOOOOOOOXXXXXXXXXXXOXXXXXXXXXXXX
XXXOOOOOOOOOOXXOOOOOOOOOOOOOOOOOOOOOOOOOOOOOOOOOOOOOOOOOOOOOOOOOOOOXXXXXXXXXXXXXXXXXXXXXXXOOOOOOOOOOOOOOOOOOOOOOOOOOOXXXXXXXXXXXXXXXXXXXXXXXXXXXX
XXXOOOOOOOOOXXXXOOOOOOOOOOOOOOOOOOOOOOOOOOOOOOOOOOOOOOOOOOOOOOOOXXXXXXXXXXXXXXXXXXXXXXXXXXXXXXOOOOOOOOOOOOOOOOOXXXXXXXXXXXXXXXXXXXXXXXXXXXXXXXXXX
XXXOOOOOOOOOXXXXOOOOOOOOOOOOOOOOOOOOOOOOOOOOOOOOOOOOOOOOOOOOOOOOXXXXXXXXXXXXXXXXXXXXXXXXXXXXXXOOOOOOOOOOOOOOOOOXXXXXXXXXXXXXXXXXXXXXXXXXXXXXXXXXX
XXXOOOOOOOXXXXXXXXOOOOOOOOOOOOOOOOOOOOOOOOOOOOOOOOOOOOOOOOOOXXXXXXXXXXXXXXXXXXXXXXXXXXXXXXXXXXXXXXXXXXXXXXXXXXXXXXXXXXXXXXXXXXXXXXXXXXXXXXXXXXXXX
XXXOOOOOOXXXXXXXXXXXXOOOOOOOOOOOOOOOOOOOOOOOOOOOOOOOOOOXXXXXXXXXXXXXXXXXXXXXXXXXXXXXXXXXXXXXXXXXXXXXXXXXXXXXXXXXXXXXXXXXXXXXXXXXXXXXXXXXXXXXXXXXX
XXXOOOOOOXXXXXXXXXXXXOOOOOOOOOOOOOOOOOOOOOOOOOOOOOOOOOOXXXXXXXXXXXXXXXXXXXXXXXXXXXXXXXXXXXXXXXXXXXXXXXXXXXXXXXXXXXXXXXXXXXXXXXXXXXXXXXXXXXXXXXXXX
XXXXXXXXXXXXXXXXXXXXXXXXXXXXXXXXXXXXXXXXXXXXXXXXXXXXXXXXXXXXXXXXXXXXXXXXXXXXXXXXXXXXXXXXXXXXXXXXXXXXXXXXXXXXXXXXXXXXXXXXXXXXXXXXXXXXXXXXXXXXXXXXX
XXXXXXXXXXXXXXXXXXXXXXXXXXXXXXXXXXXXXXXXXXXXXXXXXXXXXXXXXXXXXXXXXXXXXXXXXXXXXXXXXXXXXXXXXXXXXXXXXXXXXXXXXXXXXXXXXXXXXXXXXXXXXXXXXXXXXXXXXXXXXXXXX
XXXXXXXXXXXXXXXXXXXXXXXXXXXXXXXXXXXXXXXXXXXXXXXXXXXXXXXXXXXXXXXXXXXXXXXXXXXXXXXXXXXXXXXXXXXXXXXXXXXXXXXXXXXXXXXXXXXXXXXXXXXXXXXXXXXXXXXXXXXXXXXXX