XXYYZZZZZZZZZZZZZZZZZZZYYXXXYYZZZZZZYYYYYYYYXXXXXXYYZZZZZYYYYYYYYYYYYYXXYYYYYYYXXXXXX
XXYYZZZZZZZZZZZZZZZZZZZYYXXXYYZZZZZZYYYYYYYXXXXXXXYZZZZZZYYYYYYYYYYYXXXXXYYYYYYXXXXXX
XXOOOOOZZZZZZZZZZZZZZZZYYYYYYYZZZZZZYYYYYYYXXXXXXXYZZZZZZYYYYYYYYYYXXXXXXXYYYYYXXXXXX
XXSOSOSZZZZZZZZZZZZZZZZYYYYYYZZZZZZZYYYYYYYXXXXXXXYZZZZZZYYYYYYYYYYXXXXXXXYYYYYXXXXXX
XXOSOSOZZZZZZZZZZZZZZZZYYYYYYZZZZZZZYYYYYYYXXXXXXYYZZZZZZYYYYYYYYYYXXXXXXXYYYYYXXXXXX
XXSOSOSZZZZZZZZZZZZZZZZYYYYYYZZZZZZYYYYYYYYXXXXXXYYZZZZZZYYYYYYYYYYXXXXXXXYYYYYXXXXXX
XXOOOOOZZZZZZZZZZZZZZZZYYYYYYZZZZZZYYYYYYYYXXXXXXYYZZZZZZYYYYYYYYYYXXXXXXXYYYYYXXXXXX
XXYYOZZZZZZZZZZZZZZZZZZYYYYYYZZZZZYYYYYYYYYXXXXXXYYZZZZZYYYYYYYYYYXXXXXXXXYYYYYXXXXXX
XXYYOZZZZZZZZZZZZZZZZZZYYYYYYZZZZYYYYYYYYYYYXXXXYYYYZZZYYYYYYYYYYYXXXXXXXYYYYYYXXXXXX
XXYYOZZZZZZYYYYZZZZZZZZYYYYYYYZZYYYYYYYYYYYYXXXYYYYYYYYYYYYYYYYYYYYXXXXXXYYYYYYXXXXXX
XXYYOZZZZZYYYYYYZZZZZZYYYYYYYYYYYYYYYYYYYYYYYYYYYYYYYYYYYYYYYYYYYYYXXXXXYYYZYYYXXXXXX
XXYYOOZZZZYYYYYYYYZZZZYYYYYYYYYYYYYYYYYZZZYYYYYYYYYYYYYYYYYYYYYYYYYXXXYYYZZZZZYXXXXXX
XXXYOZOZZYYYXXXXYYYYZZYYYYYYYYYYYYYYYYZZZZZYYYYYYYYYYYYYYYYYYYYYYYYYYYYYZZZZZZYYXXXXX
XXXYOOOOZYYXXXXXXYYYZZZYYYYYYYYYYYYYYZZZZZZZYYYYYYYYYYYYYYZZZYYYYYYYYYYZZZZZZZYYXXXXX
XXXYOZZZOYYXXXXXXYYYZZZZYYYYYYYYYYYYYZZZZZZZYYYYYYYYYYYYYZZZZZZYYYYYYYZZZZZZZZYYXXXXX
XXXYOOZYOOXXXXXXXXYYZZZZZYYYYYYYYYYYYZZZZZZZYYYYYYXXXYYYYZZZZZZZYYYYYZZZZZZZZZZYXXXXY
XXXXOYOYOYOXXXXXXXYYZZZZZZYYYYYYYYYYYZZZZZZZYYYYYYXXXXYYYZZZZZZZYYYYZZZZZZZZZZZYXXXXY
XXXXOOOOOOOOXXXXXXYYZZZZZZYYYYYYYYYYYZZZZZZZYYYYYXXXXXYYYZZZZZZZYYYYZZZZZZZZZZZYXXXXY
XXXXOYYYYYOXOXXXXXYYZZZZZZYYYYYYXXYYYZZZZZZZYYYYYXXXXXXYYZZZZZZZYYYZZZZZZZZZZZZYXXXXY
XXXXOOYYYYOXOOXXXXYZZZZZZZYYYYYYXXYYYZZZZZZZYYYYYXXXXXXYYZZZZZZZYYYZZZZZZZZZZZZYXXXXY
XXXXOYOYYYOXOXOXXXYZZZZZZZYYYYYYXXXYYZZZZZZZYYYYYYXXXXXYYZZZZZZZYYZZZZZZZZZZZZZYXXXXY
XXXXOOOOYYOXOOOOXXYZZZZZZYYYYYYYXXXYYZZZZZZZYYYYYYXXXXXXYZZZZZZZYYZZZZZZZZZZZZZYXXXXY
YYXXOYYYOYOOOXXXOYYZZZZZZYYYYYYYXXXXYZZZZZZZYYYYYYYXXXXXYYZZZZZZYYYZZZZZZZZZZZYYXXXXY
YYYYOOYYOOOOOOYYOOZZZZZZYYYYYYYXXXXXYZZZZZZZYYYYYYYXXXXXXYZZZZZZYYYZZZZZZZZZYYYYXXXXX
YYYYOYOYOYOY3YOYOYOZZZZYYYYYYYYXXXXXYYZZZZZZYYYYYYYYXXXXXYZZZZZZYYYZZZZYYYYYYYYYXXXXX
YYYYOOOOOOO333OOOOOOZZZYYYYYYYYXXXXXXYZZZZZZYYYYYYYYXXXXXYYZZZZZYYYYYYYYYYYYYYYXXXXXX
ZYYYOYYYYYYYYYYYYYZZOZZYYYYYYYYXXXXXXYZZZZZZYYYYYYYYYXXXXXYYYZYYYYYYYYYYYYYYYYYXXXXXY
ZZYYOOYYYYYYYYYYYYZZOOZYYYYYYYYXXXXXXYZZZZZZZZZZZZZYYXXXXXYYYYYYYXXYYYXXXXXXXXXXXXXXY
ZZZYOYOXYYYYYYYYYYZZOZOYYYYYYYYXXXXXXYZZZZZZZZZZZZZZYYXXXXYYYYYYXXXXXXXXXXXXXXXXXXXXY
ZZZYOOOOXYYYYYYYYYYZOOOOYYYYYYYXXXXXXYZZZZZZZZZZZZZZYYYXXXXYYYYXXXXXXXXXXXXXXXXXXXXXY
ZZZYOYXXOYYYYYYYYYYYOYYYOYZZYYYXXXXXXYYZZZZZZZZZZZZZYYYYXXXXYYXXXXXXXXXXXXXXXXXXXXXYY
ZZZYOOXXOOYYYYYYYYYYOOYYOOZZZYYXXXXXXYYZZZZZZZZZZZZZZYYYXXXXXXXXXXXXXXXXXXXXXXXXXXXYY
ZZZYOXOXOYOYYZYYYYYYOYOYOZOZZYYXXXXXXYYZZZZZZZZZZZZZZYYYYXXXXXXXXXXXXXXXXXXXXXXXXXXYY
ZZZYOOOOOOOOZZZYYYYYOOOOOOOOZYYXXXXXXYYZZZZZZZZZZZZZZZYYYXXXXXXXXXXXXXXXXXXXXXXXXXXYY
ZZZYOXXXXYYYOZZYYYYYOYYYYZZZOZYXXXXXXYYZZZZZZZZZZZZZZZZYYYXXXXXXXXXXXXXXXXXXXXXXXXXYY
ZZZYOOXXXYYYOOZYYYYXOOYYYZZZOOYXXXXXXYYZZZZZZZZZZZZZZZZZYYXXXXXXXXXXXXXXXXXXXXXXXXXYY
ZZZYOXOXXYYZOZOZYYXXOXOYZZZZOZOXXXXXXYYZZZZZZZZZZZZZZZZZYYYYYXXXXXXXXXXXXYYYYXXXXXXYY
ZZZYOOOOXYYZOOOOYYXXOOOOZZZZOOOOXXXXXYYZZZZZYYYYYYYZZZZZZYYYYYYYYXXXXXXXYYYYYYYXXXXYY
ZZZYOXXXOYYZOZZZOYXXOXXYOZZZOZYXOXXXXYYYZZZYYYYYYYYYZZZZZYYYYYYYYYXXXXXYYYYYYYYYYXYYY
ZZZYOOXXOOYZOOZZOOXXOOXYOOZZOOYXOOXXXYYYYYYYYYYYYYYYZZZZZYYYYYYYYYXXXXYYYZZZZZYYYYYYY
ZZYYOXOXOYOZOZOZOYOXOXOYOZOZOZOXOXOXYYYYYYYYYYYYYXXYYZZZZYYYYYYYYYYYYYYYZZZZZZZYYYYYY
ZZYYOOOOOOOOOOOOOOOOOOOOOOOOOOOOOOOOYYYYYYYYXXXXXXXXYYYZZYYYYYYYYYYYYYYZZZZZZZZZYYYYX
ZZYYOXXXYYZZZZZZZYYYYYYYZZZZZZYYXXXYOYYYYYXXXXXXXXXXYYYYYYYYYYYYYYYYYYYZZZZZZZZZZYYYX
ZYYYOOXXYYZZZZZZZZYYYYYYZZZZZYYYYYYYOOYYYXXXXXXXXXXXXYYYYYYYYYYYYYYYYYZZZZZZZZZZZYYYX
ZYYYOXOXYYZZZZZZZZYYYYYYZZZZZYYYYYYYOYOYXXXXXXXXXXXXXXYYYYYYYYYYZYYYYZZZZZZZZZZZZZYYX
YYYYOOOOYYZZZZZZZZYYYYYYZZZZZYYYYYYYOOOOXXXXXXXXXXXXXXYYYYYYYYYYZZYYZZZZZZZZZZZZZZYYX
YYYYOXXY1YZZZZZZZZZYYYYYZZZZYYYYYYYYOYYXOXXXXXXXXXXXXXXYYYYYYYYYZZYZZZZZZZZZZZZZZZZYY
YYYYOOXY11ZZZZZZZZZYYYYYYYYYYYYYYZZZOOYXOOXXXXXXXXXXXXXYYYYYYYYYZZZZZZZZZZZZZZZZZZZYY
YYYYOXOYOYOZZZZZZZZYYYYYYYYYYYYYZZZZOYOXOXOXXYYYYXXXXXXXYYYYYYYYYYYZZZZZZZZZZZZZZZZYY
YYYYOOOOOOOOZZZZZZZZYYYYYYYYYYYYZZZZOOOOOOOOXYYYYYXXXXXXYYYYYYYYYYYZZZZZZZZZZZZZZZZZY
YYYYOYYYYYYYOZZZYYZZYYYYYYYYYYYZZZZZOYXXXXXXOYYYYYYXXXXXXYYYYYYYYYYYYZZZZZZZZZZZZZZZY
XXYYOOYYYYYYOOYYYYYYYYYYYYYYYYYZZZZZOOXXXXXXOOZZZYYYXXXXXYYYYYYYYYYYYYYYYYYYYYYZZZZZZ
XXYYOYOYYYYYOYOYYYYYYYYYYYYYYYYZZZZZOYOXXXXXOZOZZZYYXXXXXYYYYYYYYYYYYYYYYYYYYYYZZZZZZ
XYYYOOOOYYYYOOOOYYYYYYYYYYYYYYYZZZZZOOOOXXXXOOOOZZZYYYXXXYYYYYYYYYYYYYYYYYYYYYYYZZZZZ
XYYZOYYYOYYYOYYYOYYYYYYYYYYYYYYYZZZZOYYXOXXYOZZZOZZZYYYXXXYYYYYYYYYYYYYYYYYYYYYYZZZZY
XYYZOOYYOOXXOOYYOOYYYYYYYYYYYYYYZZZZOOYXOOXYOOZZOOZZZYYYXXXXXYYYYYYYYYYXXXYYYYYYYZZZY
XYYZOYOYOXOXOXOYOYOYYYYYYYYYYYXYYZZZOZOXOXOYOZOZOZOZZYYYXXXXXXYYYYYYYYYXXXXXYYYYYYYYY
XYYZOOOOOOOOOOOOOOOOXYYYYYYYYYXYYYZZOOOOOOOOOOOOOOOOZYYYYXXXXXXYYYYYYYYXXXXXXXXYYYYYY
XYZZOZZYYXXXXXXXXXXXOXYYYYYYYYXYYYYZOZYYXXYYYZZZZZZZOZYYYXXXXXXYYYYYYYYXXXXXXXXYYYYYY
XYZZOOZYYXXXXXXXXXXXOOYYYYYYYYXYYYYYOOYYYXYYYZZZZZZZOOYYYXXXXXXYYYYZYYYXXXXXXXXYYYYYY
XYYZOZOYYXXXXXXXXXXXOXOYYYYYYYXXYYYYOZOYYYYYYZZZZZZZOZOYYXXXXXXYYYZZZYYXXXXXXXXYYYYYY
XYYZOOOOYYXXXYYYYXXXOOOOYYYYYYXXYYYYOOOOYYYYYZZZZZZZOOOOYYXXXXXXYYZZZYYXXXXYYYYYYYYYY
XYYZOZZZOYXYYYYYYXXXOXXYOZZZYYYXXYYYOZYYOYYYYZZZZZZZOZZYOYXXXXXXYYZZZZYYXXYYYYYYYYYYY
XXYZOOZZOOYYYYYYYXXXOOXYOOZZZYYXXXXYOOYYOOYYYZZZZZZZOOZYOOXXXXXXYYZZZZYYYYYYYYYYYYYYY
XXYZOZOZOYOYYYYYYXXXOXOYYZOZZYYXXXXXOYOYOYOYYZZZZZZZOZOYOYOXXXXXYYZZZZZYYYYYYYYYYYYYY
XXYYOOOOOOOOYYYYYYXXOOOOOOOOZZYYXXXXOOOOOOOOYZZZZZZYOOOOOOOOXXXXYYZZZZZYYYYYYYYYYYYYY
XXXYOZZZZZYYOYYYYYXXOXXYZZZZOZYYXXXXOYYYYYYYOYYZYYYYOYZZZYYXOXXXYYZZZZZYYYYYYYYYYYYYY
XXXYOOZZZZZZOOYYYYXXOOYYZZZZOOYYXXXXOOYYYYYYOOYYYYYYOOYZZZYYOOXXYYZZZZZYYYYYYYYYYYYYY
XXXYOZOZZZZZOZOYYYYXOXOYZZZZOZOYYXXXOYOYYXYYOYOYYYXXOYOZZZYYOXOXXYZZZZZYYYYYYYYYYYYYZ
XXXYOOOOZZZZOOOOYYYYOOOOZZZZOOOOYXXXOOOOYXXYOOOOXXXXOOOOZZZYOOOOXYYZZZZYYYYYYYYYYYYZZ
XXXYOYZZOZZZOZZYOYYYOYYYOZZZOZZYOYXYOYYYOXXXOXXXOXXXOYZZOZZYOXXXOYYZZZZYYYYYYYXYYYZZZ
XXXYOOZZOOZZOOZYOOYYOOYYOOZZOOZYOOYYOOYYOOXXOOXXOOXXOOZZOOZYOOXXOOYZZZYYYYYYYYXYYYZZZ
XXXYOYOZOZOZOZOYOYOYOYOYOZOZOZOYOYOYOYOYOXOXOXOXOXOXOY4ZOZOYOXOX2YOYZZYYYYYYYYXYFYZZZ
XXXYOOOOOOOOOOOOOOOOOOOOOOOOOOOOOOOOOOOOOOOOOOOOOOOOO444OOOOOOO22OOOOOOOOOOOOOOFFFZZZ
X1X123334ZZZZZZYYYYYYYYYYZZZZZZYYYYYYYYYYYYXXXXXXXXXYYZZZZZYXXXXXYYYYYYYYYYYYYXYFZZZZ
X1X12Y3Y4ZZZZZYYYYZZZZYYYZZZZZZYYYYYYYYYYYYYYXXXXXXXYYZZZZZYXXXXXYYYYYYYYYYYYYYYYZZZZ
X111223Y4ZZZZYYYYYZZZZZYYZZZZZZYYYYYYYYYYYYYYXXXXXXXYZZZZZYYXXXXXYYYYYYYYYYYYYYYYZZZZ
YYYYXXXXYYZYYYYYYYZZZZZYYZZZZZYYYYYYYYYYYYYYYXXXXXXYYZZZZZYYXXXXXYYYYYYYYYYYYYYYZZZZZ