XXXXXXXYYYYYYYYXXXXXXXXXXXXXXYYYYYYYYZZZZZZZYYYYXXXXXXXYYYYYYYXXX
XXXXXXXYYYYYYYYXXXXXXXXXXXXXYYYYYYYYYZZZZZZZYYYXXXXXXXXXYYYYYYXXX
XXXXXXXYYYYYYYYXXXXXXXXXXXYYYYYYYYYYYZZZZZZZYYXXXXXXXXXYYYYYYYXXX
XXXXXXXYYYYYYYYXXXXXXXXXXYYYYYYYYYYYYYZZZZZYYXXXXXXXXXYYYYYYYYYYY
XXXXXOOYYYYOOOOYXXXOOOOXXYYOOOOZZYYOOOOYYYYOOOOXXXXOOOOYZZZOOYYYY
YYYYYOOOZZOOOOOOYXOOOOOOYYOOOOOOZYOOOOOOYYOOOOOOXXOOOOOOZZOOOYYYY
YYYZZZOOOOOOZZOOOOOOXXOOOOOOZZOOOOOOYYOOOOOOYYOOOOOOYZOOOOOOYYYYY
YZZZZZZOOOOZZZZOOOOXXXYOOOOZZZYO444YYZZOOOOZYYYOOOOYZZZOOOOZYYYYY
ZZZZZZZZOOZZZZZYOOYYYYYYOOYYYYYY44YYYZZZOOZZZZYYOOZZZZZZOOZYYYYYY
ZZZZZZZOOZZZZZZOOYYYYYYOOYYYYYYOOYYYYYZOOZZZZZZOOZZZZZZOOYYYYYYYY
ZZZZZZOOOOZZZYOOOOYYYYOOOOYYXXOOOOYYYYOOOOYYYZOOOOZZYYOOOOYYYYYYY
ZZZZYOOOOOOYYOOOOOOYYOOOOOOXXOOOOOOYYOOOOOOYYOOOOOOYYOOOOOOYYYYXX
ZZYYOOOXYOOOOOOXXOOOOOOYYOOOOOOXYOOOOOOYYOOOOOOYYOOOOOOYYOOOYYYYX
ZYYYOOXXXXOOOOXXXXOOOOYYYYOOOOXXYYOOOOYYYYOOOOXXXXOOOOXXYYOOYYYYY
ZYYYYOOXXXXOOXXOOOOXXXYOOOOXXXXOOOOZZZOOOOOOXXXOOOOXXOOXYYYOOZZYY
YYYYXOOOXYOOOOOOOOOOXOOOOOOOXOOOOOOOZOOOOOOOXOOOOOOOXOOOYYOOOZZYY
YYYYYXOOOOOOOOOXXXO33OOYYYYOOOOXYYOOOZOOYYXXOOOXXXOOOXOOOOOOYYYYX
YYYYYYYOOOOZOOYYXXX33OOYYYXXOOXXXYYOOZOOZYYXOOYYYYYOOYYOOOOYYYYYX
YYYYYYYYOOZZOOZYYYY3OYOOOOXXOOXXXXYOOZOOOOOOOOYYYYYOOYYYOOYYYYYXX
YYYYYYYOOZZZOOZZZYYOOYYOOOOXOOXXXXYOOZOOOOOOOOYYYYYOOYYOOYYYYYXXX
YYYYYYOOOOZZOOZZZZZOOYYYYYOOOOXXXXXOOYOOYYYYOOYYYZZOOZOOOOYYYXXXX
YYYYYOOOOOOZOOOZZZOOOOYYYYOOOOOXXXOOOYOOYYYYOOOYYZOOOOOOOO2YYXXXX
YYYYOOOYYOOOZOOOOOOOYOOOOOOOXOOOOOOOYOOOYYYYYOOOOOOOOOOZZO22YXXXX
ZZZZOOYYYYOOYYOOOOYYYYOOOOYYYYOOOOXXXOOYYYYYYYOOOOYYOOZZZZOOYYXXX
ZZZZZOOYXXXOOOOYYYYOOOOYYYYOOOOYYYYOOOOXXYYOOOOYYYYOOOOZZZZOOYYXX
ZZZZZOOOYXOOOOOOXXOOOOOOXXOOOOOOYYOOOOOOXYOOOOOOYYOOOOOOZZOOOZYYY
ZZZZZZOOOOOOXXOOOOOOXXOOOOOOXYOOOOOOYYO11OOOYYOOOOOOYYOOOOOOZZZYY
ZZZZZZZOOOOXXXXOOOOXXXXOOOOXXXYOOOOYYYY11OOYYYYOOOOYYZZOOOOZZZZZY
ZZZZZZZYOOXXXXXXOOXXXXXXOOXXXXYYOOYYYYYYOOYYYYYYOOYYYZZZOOZZZZZZY
YZZZZZZOOXXXXXXOOXXXXXXOOXXXXYYOOYYYYYYOOYYYYYYOOYYYYYZOOZZZZZZZY
YYYOOOOOOOXXXXOOOOYYYYOOOOXYYYOOOOYYYYOOOOYYYYOOOOYYYYOOOOZZZZZYY
YYYSOOOOOOOXXOOOOOOYYOOOOOOYYOOOOOOYYOOOOOOYYOOOOOOYYOOOOOOYYYYXX
YYYSSOOOOOOOOOOZZOOOOOOZZOOOOOOZZOOOOOOYYOOOOOOYYOOOOOOYYOOOYYYXX
YYYFSSOOOXOOOOYZZZOOOOZZZZOOOOZZZZOOOOZYYYOOOOYYYYOOOOYXXXOOXXXXX
YYYXFSSOOXXXYYZZZZZZZZZZZZZZZZZZZZZZZZZYYYYYYYYYYYYYYYXXXXXXXXXXY
YYYYXOSOOXXXYYZZZZZZZZZZZZZZZZZZZZZZZZYYYYYYYYYYYYYYYYXXXXXXXXXXY
YYYYXXXXXXXXYYYZZZZZZZZZZZYYYYYZZZZZYYYYYYYYYZZZZZYYYYXXXXXXXXXYY
YYYYYYXXXXXXYYYYZZZZZZZZYYYYYYYYYYYYYYYXYYYYYZZZZZZYYYXXXXXXXXYYZ