XXXOXXXXXXXXXXXXXXXXXXXXXXXXXXXXXXXXXXXXXXXXXXXXXXXXXXXXXXXXXXXXXXXXXXXXXXXXXX
XXXOOXXXXXXXXXXXXXXXXXXXXXXXXXXXXXXXXXXXXXXXXXXXXXXXXXXXXXXXXXXXXXXXXXXXXXXXXX
XXXOXOXXXXXXXXXXXXXXXXXXXXXXXXXXXXXXXXXXXXXXXXXXXXXXXXXXXXXXXXXXXXXXXXXXXXXXXX
XXXOOOOXXXXXXXXXXXXXXXXXXXXXXXXXXXXXXXXXXXXXXXXXXXXXXXXXXXXXXXXXXXXXXXXXXXXXXX
XXXOXXXOXXXXXXXXXXXXXXXXXXXXXXXXXXXXXXXXXXXXXXXXXXXXXXXXXXXXXXXXXXXXXXXXXXXXXX
XXXOOXXOOXXXXXXXXXXXXXXXXXXXXXXXXXXXXXXXXXXXXXXXXXXXXXXXXXXXXXXXXXXXXXXXXXXXXX
XXXOXOXOXOXXXXXXXXXXXXXXXXXXXXXXXXXXXXXXXXXXXXXXXXXXXXXXXXXXXXXXXXXXXXXXXXXXXX
XXXOOOOOOOOXXXXXXXXXXXXXXXXXXXXXXXXXXXXXXXXXXXXXXXXXXXXXXXXXXXXXXXXXXXXXXXXXXX
XXXOXXXXXOXOXXXXXXXXXXXXXXXXXXXXXXXXXXXXXXXXXXXXXXXXXXXXXXXXXXXXXXXXXXXXXXXXXX
XXXOOXXXXOXOOXXXXXXXXXXXXXXXXXXXXXXXXXXXXXXXXXXXXXXXXXXXXXXXXXXXXXXXXXXXXXXXXX
XXXOXOXXXOXOXOXXXXXXXXXXXXXXXXXXXXXXXXXXXXXXXXXXXXXXXXXXXXXXXXXXXXXXXXXXXXXXXX
XXXOOOOXXOXOOOOXXXXXXXXXXXXXXXXXXXXXXXXXXXXXXXXXXXXXXXXXXXXXXXXXXXXXXXXXXXXXXX
XXXOXXXOXOOOXXXOXXXXXXXXXXXXXXXXXXXXXXXXXXXXXXXXXXXXXXXXXXXXXXXXXXXXXXXXXXXXXX
XXXOOXXOOOOOOXXOOXXXXXXXXXXXXXXXXXXXXXXXXXXXXXXXXXXXXXXXXXXXXXXXXXXXXXXXXXXXXX
XXXOXOXOXOXOXOXOXOXXXXXXXXXXXXXXXXXXXXXXXXXXXXXXXXXXXXXXXXXXXXXXXXXXXXXXXXXXXX
XXXOOOOOOOOOOOOOOOOXXXXXXXXXXXXXXXXXXXXXXXXXXXXXXXXXXXXXXXXXXXXXXXXXXXXXXXXXXX
XXXOXXXXXXXXXXXXXXXOXXXXXXXXXXXXXXXXXXXXXXXXXXXXXXXXXXXXXXXXXXXXXXXXXXXXXXXXXX
XXXOOXXXXXXXXXXXXXXOOXXXXXXXXXXXXXXXXXXXXXXXXXXXXXXXXXXXXXXXXXXXXXXXXXXXXXXXXX
XXXOXOXXXXXXXXXXXXXOXOXXXXXXXXXXXXXXXXXXXXXXXXXXXXXXXXXXXXXXXXXXXXXXXXXXXXXXXX
XXXOOOOXXXXXXXXXXXXOOOOXXXXXXXXXXXXXXXXXXXXXXXXXXXXXXXXXXXXXXXXXXXXXXXXXXXXXXX
XXXOXXXOXXXXXXXXXXXOXXXOXXXXXXXXXXXXXXXXXXXXXXXXXXXXXXXXXXXXXXXXXXXXXXXXXXXXXX
XXXOOXXOOXXXXXXXXXXOOXXOOXXXXXXXXXXXXXXXXXXXXXXXXXXXXXXXXXXXXXXXXXXXXXXXXXXXXX
XXXOXOXOXOXXXXXXXXXOXOXOXOXXXXXXXXXXXXXXXXXXXXXXXXXXXXXXXXXXXXXXXXXXXXXXXXXXXX
XXXOOOOOOOOXXXXXXXXOOOOOOOOXXXXXXXXXXXXXXXXXXXXXXXXXXXXXXXXXXXXXXXXXXXXXXXXXXX
XXXOXXXXXXXOXXXXXXXOXXXXXXXOXXXXXXXXXXXXXXXXXXXXXXXXXXXXXXXXXXXXXXXXXXXXXXXXXX
XXXOOXXXXXXOOXXXXXXOOXXXXXXOOXXXXXXXXXXXXXXXXXXXXXXXXXXXXXXXXXXXXXXXXXXXXXXXXX
XXXOXOXXXXXOXOXXXXXOXOXXXXXOXOXXXXXXXXXXXXXXXXXXXXXXXXXXXXXXXXXXXXXXXXXXXXXXXX
XXXOOOOXXXXOOOOXXXXOOOOXXXXOOOOXXXXXXXXXXXXXXXXXXXXXXXXXXXXXXXXXXXXXXXXXXXXXXX
XXXOXXXOXXXOXXXOXXXOXXXOXXXOXXXOXXXXXXXXXXXXXXXXXXXXXXXXXXXXXXXXXXXXXXXXXXXXXX
XXXOOXXOOXXOOXXOOXXOOXXOOXXOOXXOOXXXXXXXXXXXXXXXXXXXXXXXXXXXXXXXXXXXXXXXXXXXXX
XXXOXOXOXOXOXOXOXOXOXOXOXOXOXOXOXOXXXXXXXXXXXXXXXXXXXXXXXXXXXXXXXXXXXXXXXXXXXX
XXXOOOOOOOOOOOOOOOOOOOOOOOOOOOOOOOOXXXXXXXXXXXXXXXXXXXXXXXXXXXXXXXXXXXXXXXXXXX
XXXOXXXXXXXXXXXXXXXXXXXXXXXXXXXXXXXOXXXXXXXXXXXXXXXXXXXXXXXXXXXXXXXXXXXXXXXXXX
XXXOOXXXXXXXXXXXXXXXXXXXXXXXXXXXXXXOOXXXXXXXXXXXXXXXXXXXXXXXXXXXXXXXXXXXXXXXXX
XXXOXOXXXXXXXXXXXXXXXXXXXXXXXXXXXXXOXOXXXXXXXXXXXXXXXXXXXXXXXXXXXXXXXXXXXXXXXX
XXXOOOOXXXXXXXXXXXXXXXXXXXXXXXXXXXXOOOOXXXXXXXXXXXXXXXXXXXXXXXXXXXXXXXXXXXXXXX
XXXOXXXOXXXXXXXXXXXXXXXXXXXXXXXXXXXOXXXOXXXXXXXXXXXXXXXXXXXXXXXXXXXXXXXXXXXXXX
XXXOOXXOOXXXXXXXXXXXXXXXXXXXXXXXXXXOOXXOOXXXXXXXXXXXXXXXXXXXXXXXXXXXXXXXXXXXXX
XXXOXOXOXOXXXXXXXXXXXXXXXXXXXXXXXXXOXOXOXOXXXXXXXXXXXXXXXXXXXXXXXXXXXXXXXXXXXX
XXXOOOOOOOOXXXXXXXXXXXXXXXXXXXXXXXXOOOOOOOOXXXXXXXXXXXXXXXXXXXXXXXXXXXXXXXXXXX
XXXOXXXXXXXOXXXXXXXXXXXXXXXXXXXXXXXOXXXXXXXOXXXXXXXXXXXXXXXXXXXXXXXXXXXXXXXXXX
XXXOOXXXXXXOOXXXXXXXXXXXXXXXXXXXXXXOOXXXXXXOOXXXXXXXXXXXXXXXXXXXXXXXXXXXXXXXXX
XXXOXOXXXXXOXOXXXXXXXXXXXXXXXXXXXXXOXOXXXXXOXOXXXXXXXXXXXXXXXXXXXXXXXXXXXXXXXX
XXXOOOOXXXXOOOOXXXXXXXXXXXXXXXXXXXXOOOOXXXXOOOOXXXXXXXXXXXXXXXXXXXXXXXXXXXXXXX
XXXOXXXOXXXOXXXOXXXXXXXXXXXXXXXXXXXOXXXOXXXOXXXOXXXXXXXXXXXXXXXXXXXXXXXXXXXXXX
XXXOOXXOOXXOOXXOOXXXXXXXXXXXXXXXXXXOOXXOOXXOOXXOOXXXXXXXXXXXXXXXXXXXXXXXXXXXXX
XXXOXOXOXOXOXOXOXOXXXXXXXXXXXXXXXXXOXOXOXOXOXOXOXOXXXXXXXXXXXXXXXXXXXXXXXXXXXX
XXXOOOOOOOOOOOOOOOOXXXXXXXXXXXXXXXXOOOOOOOOOOOOOOOOXXXXXXXXXXXXXXXXXXXXXXXXXXX
XXXOXXXXXXXXXXXXXXXOXXXXXXXXXXXXXXXOXXXXXXXXXXXXXXXOXXXXXXXXXXXXXXXXXXXXXXXXXX
XXXOOXXXXXXXXXXXXXXOOXXXXXXXXXXXXXXOOXXXXXXXXXXXXXXOOXXXXXXXXXXXXXXXXXXXXXXXXX
XXXOXOXXXXXXXXXXXXXOXOXXXXXXXXXXXXXOXOXXXXXXXXXXXXXOXOXXXXXXXXXXXXXXXXXXXXXXXX
XXXOOOOXXXXXXXXXXXXOOOOXXXXXXXXXXXXOOOOXXXXXXXXXXXXOOOOXXXXXXXXXXXXXXXXXXXXXXX
XXXOXXXOXXXXXXXXXXXOXXXOXXXXXXXXXXXOXXXOXXXXXXXXXXXOXXXOXXXXXXXXXXXXXXXXXXXXXX
XXXOOXXOOXXXXXXXXXXOOXXOOXXXXXXXXXXOOXXOOXXXXXXXXXXOOXXOOXXXXXXXXXXXXXXXXXXXXX
XXXOXOXOXOXXXXXXXXXOXOXXXOXXXXXXXXXOXOXOXOXXXXXXXXXOXOXOXOXXXXXXXXXXXXXXXXXXXX
XXXOOOOOOOOXXXXXXXXOOOOOOOOXXXXXXXXOOOOOOOOXXXXXXXXOOOOOOOOXXXXXXXXXXXXXXXXXXX
XXXOXXXXXXXOXXXXXXXOXXXXXXXOXXXXXXXOXXXXXXXOXXXXXXXOXXXXXXXOXXXXXXXXXXXXXXXXXX
XXXOOXXXXXXOOXXXXXXOOXXXXXXOOXXXXXXOOXXXXXXOOXXXXXXOOXXXXXXOOXXXXXXXXXXXXXXXXX
XXXOXOXXXXXOXOXXXXXOXOXXXXXOXOXXXXXOXOXXXXXOXOXXXXXOXOXXXXXOXOXXXXXXXXXXXXXXXX
XXXOOOOXXXXOOOOXXXXOOOOXXXXOOOOXXXXOOOOXXXXOOOOXXXXOOOOXXXXOOOOXXXXXXXXXXXXXXX
XXXOXXXOXXXOXXXOXXXOXXXOXXXOXXXOXXXOXXXOXXXOXXXOXXXOXXXOXXXOXXXOXXXXXXXXXXXXXX
XXXOOXXOOXXOOXXOOXXOOXXOOXXOOXXOOXXOOXXOOXXOOXXOOXXOOXXOOXXOOXXOOXXXXXXXXXXXXX
XXXOXOXOXOXOXOXOXOXOXOXOXOXOXOXOXOXOXOXOXOXOXOXOXOXOXOXOXOXOXOXOXOXXXXXXXXXXXX
XXXOOOOOOOOOOOOOOOOOOOOOOOOOOOOOOOOOOOOOOOOOOOOOOOOOOOOOOOOOOOOOOOOOOOOOOOOOOO