PXXXXXXXXXXXXXXXXXXXXXXXXXXXXXXXXXXX
PXXXXXXOOO2OOXXXXXXXXOOOOOOOOOOXXXXX
PXXXXOOOOO2OOOOXXXXXOOOOOOOOOOOOXXXX
PXXXOOOOOOXOOOOOXXXOOOOOOOOXXOOOXXXX
XXXXOOOOXXXXOOOOXXOOOOXXXXXOOXOOOXXX
XXXXXOOOXXXXOOOOXOOOOOXXXXXXXOXOOOXX
XXXXXOOOOXXXXOOOOOOOOXXXXXXXXXOOOOOX
XXXXXXOOOOOXXXXOOOOXXXXXXXXXXXOOOOOX
XXXXXXXOOOOXXXXXXXXXXXXXXXXXXXXOOOOX
XXXXXXOOOOXXXX1X123334XXXXXXXXXXOOOX
XXXOOOOOXXXXXX1X12X3X4XXXXXXXXXXOOOX
XXOOOOOXXXXFFX111223X4XXOOOXXXXXOOOX
XOOOOOXXXXXOOXXXXXXXXXXOOOOOOXXX111X
XOOOXXXXXXXOOXXXXXXXXXOOOOOOOOOOOOOX
XOOOOXXXXXXOOXXXXXXXOOOOXXXXXXOOOOXX
XXOOOOOOOOOOOOOOOOOOOOOOOXXXXOOOOXXX
XXXOOOOOOOOSSOOOOOOOOXXXOOOOXOOOXXXX
XXXXXXOOOOOOOXXXXOOOOXXXXXOOOOOXXXXX
XXXXXXXOOXXXXXXXXXXXXXXXXXXOOXXXXXXX
XXXXXOOOOOOOOOOXXXXXXXXOO4OOOXXXXXXX
XXXXOOOOOOOOOOOOXXXXXOOOO4OOOOOXXXXX
XXXXOOOXXOOOOOOOOXXXOOOOOXOOOOOOXXXX
XXXOOOXOOXXXXXOOOOXXOOOOXXXXOOOOXXXX
XXOOOXOXXXXXXXOOOOOXOOOOXXXXOOOXXXXX
XOOOOOXXXXXXXXXOOOOOOOOXXXXOOOOXXXXX
XOOOOOXXXXXXXXXXXOOOOXXXXOOOOOXXXXXX
XOOOOXXXXXXXXXXXXXXXXXXXXOOOOXXXXXXX
XOOOXXXXXXXXXX4X322111XXXXOOOOXXXXXX
XOOOXXXXXXXXXX4X3X21X1XXXXXXOOOOOXXX
XOOOXXXXXOOOXX433321X1XFFXXXXOOOOOXX
X333XXXOOOOOOXXXXXXXXXXOOXXXXXOOOOOX
XOOOOOOOOOOOOOXXXXXXXXXOOXXXXXXXOOOX
XXOOOOXXXXXXOOOOXXXXXXXOOXXXXXXOOOOX
XXXOOOOXXXXOOOOOOOOOOOOOOOOOOOOOOOXX
XXXXOOOXOOOOXXXOOOOOOOOSSOOOOOOOOXXX
XXXXXOOOOOXXXXXOOOOXXXXOOOOOOOXXXXXX
XXXXXXXOOXXXXXXXXXXXXXXXXXXOOXXXXXXX
XXXXXXOOOOOOOXXXXOOOOXXXXXOOOOOXXXXX
XXXOOOOOOOOSSOOOOOOOOXXXOOOOXOOOXXXX
XXOOOOOOOOOOOOOOOOOOOOOOOXXXXOOOOXXX
XOOOOXXXXXXOOXXXXXXXOOOOXXXXXXOOOOXX
XOOOXXXXXXXOOXXXXXXXXXOOOOOOOOOOOOOX
XOOOOOXXXXXOOXXXXXXXXXXOOOOOOXXX555X
XXOOOOOXXXXFFX111223X4XXOOOXXXXXOOOX
XXXOOOOOXXXXXX1X12X3X4XXXXXXXXXXOOOX
XXXXXXOOOOXXXX1X123334XXXXXXXXXXOOOX
XXXXXXXOOOOXXXXXXXXXXXXXXXXXXXXOOOOX
XXXXXXOOOOOXXXXOOOOXXXXXXXXXXXOOOOOX
XXXXXOOOOXXXXOOOOOOOOXXXXXXXXXOOOOOX
XXXXXOOOXXXXOOOOXOOOOOXXXXXXXOXOOOXX
XXXXOOOOXXXXOOOOXXOOOOXXXXXOOXOOOXXX
XXXXOOOOOOXOOOOOXXXOOOOOOOOXXOOOXXXX
XXXXXOOOOO6OOOOXXXXXOOOOOOOOOOOOXXXX
XXXXXXXOOO6OOXXXXXXXXOOOOOOOOOOXXXXX
XXXXXXXOOXXXXXXXXXXXXXXXXXXOOXXXXXXX
XXXXXOOOOOOOXXXOOOOXXXXOOOOOOOOOXXXX
XXXXOOOXOOOOXXXOOOOOOOOSSOOOOOOOXXXX
XXXOOOOXXXXOOOOOOOOOOOOOOOOOOOOOOOXX
XXOOOOXXXXXXOOOOXXXXXXXOOXXXXXXOOOOX
XOOOOOOOOOOOOOXXXXXXXXXOOXXXXXXXOOOX
X777XXXOOOOOOXXXXXXXXXXOOXXXXXOOOOOX
XOOOXXXXXOOOXX4X322111XFFXXXXOOOOOXX
XOOOXXXXXXXXXX4X3X21X1XXXXXXOOOOOXXX
XOOOXXXXXXXXXX433321X1XXXXOOOOXXXXXX
XOOOOXXXXXXXXXXXXXXXXXXXXOOOOXXXXXXX
XOOOOOXXXXXXXXXXXOOOOXXXXOOOOOXXXXXX
XOOOOOXXXXXXXXXOOOOOOOOXXXXOOOOXXXXX
XXOOOXOXXXXXXXOOOOOXOOOOXXXXOOOXXXXX
XXXOOOXOOXXXXXOOOOXXOOOOXXXXOOOOXXXX
XXXXOOOXXOOOOOOOOXXXOOOOOXOOOOOOXXXX
XXXXOOOOOOOOOOOOXXXXXOOOO8OOOOOXXXXX
XXXXXOOOOOOOOOOOXXXXXOOOO8OOOOXXXXXX
XXXXXXXXXXXXXXXXXXXXXXXXXXXXXXXXXXXX