PXXXXXXXXXXXXXXXXXXXXXXXXXXXXXXXXXXXXXXXXXXXXXXXXXXXXXXXXXXXXXXXXXXXXXXXXXXXXXXXXXXXXXXXXXXXXXXXXXXXXXXXXXXXXXXXXXXXXXXXXXX
PXXXXXXXXXXYYYYYYYYYXXXXXXXXXXXXXXXXXXXXXXXXXXXXXXXXXXXXXXXXXXXXXXXXXXXXXXXXXXXXXXXXXXXXXXXXXXXXXXXXXXXXXXXXXXXXXXXXXXXXXXX
PXXXXXXYYYYYYOOOOOOOOOOOOOXXXXXXXXXXXYYYYYYYYYYXXXXXXXXXXXXXXXXXXXXXXXXXXXXXXXXXXXXXXXXXXXXXXXXXXXXXXXXXXXXXXXXXXXXXXXXXXXX
PXXXXXYYYYYOOOOOOOOOOOOOOOOOOOOOOOOOOOOOOOYYYYYYXXXXXXXXXXXXXXXXXXXXXXXXXXXXXXXXXXXXXXXXXXXXXXXXXXXXXXXXXXXXXXXXXXXXXXXXXXX
PXXXYYYYOOOOOOOOOOOOOOOOOOOOOOOOOOOOOOOOOOOOOYYYYYXXXXXXXXXXXXXXXXXXXXXXXXXXXXXXXXXXXXXXXXXXXXXXXXXXXXXXXXXXXXXXXXXXXXXXXXX
PXXYYYYYOOOOOOOOOOOOOOOOOOOOOOOOOOOOOOOOOOOOOOOYYYYXXXXXXXXXXXXXXXXXXXXXXXXXXXXXXXXXXXXXXXXXXXXXXXXXXXXXXXXXXXXXXXXXXXXXXXX
PXXYYYOOOOOOOOOOOOOOOOOOOOOOOOOOOOOOOOOOOOOOOOOOOOYYXXXXXXXXXXXXXXXXXXXXXXXXXXXXXXXXXXXXXXXXXXXXXXXXXXXXXXXXXXXXXXXXXXXXXXX
PXXYYOOOOOOOOOOOOOOOOOOOOOXXXXXXXXOOOOOOOOOOOOOOOOOOOXXXXXXXXXXXXXXXXXXXXXXXXXXXXXXXXXXXXXXXXXXXXXXXXXXXXXXXXXXXXXXXXXXXXXX
PXXYOOOOOOOOOOOOOOOOOOOOXXXXXXXXXXXXXOOOOOOOOOOOOOOOOOOXXXXXXXXXXXXXXXXXXXXXXXXXXXXXXXXXXXXXXXXXXXXXXXXXXXXXXXXXXXXXXXXXXXX
XXXYOOOOOOOOXXXXXXOOOOXXXXXXXXXXXXXXXXXXOOOOOOOOOOOYYOOOXXXXXXXXXXXXXXXXXXXXXXXXOOOOOXXXXXXXXXXXXXXXXXXXXXXXXXXXXXXXXXXXXXX
XXXYOOOOOOOXXXXXXXOOXXXXXXXXXXXXXXXXXXXXXXOOOOOOOOOYYXOOOXXXXXXXXXXXXXXXXXXXXXXOOOOXOOXXXXXXXXXXXXXXXXXXXXXXXXXXXXXXXXXXXXX
XXXOOOOOOOXXXXXXXOOXXXXXXXXXXXXXXXXXXXXXXXXXOOOOOOOYYXXXOOXXXXXXXXXXXXXXXXXXXXOOXXXXXOOXXXXXXXXXXXXXXXXXXXXXXXXXXXXXXXXXXXX
XXXOOOOOOOXXXXXXOOXXXXXXXXXXXXXXXXXXXXXXXXXXXOOOOOOOYXXXOOXXXXXXXXXXXXXXXXXXXXOOXXXXXXOXXXXXXXXXXXXXXXXXXXXXXXXXXXXXXXXXXXX
XXXOOOOOOOXXXXXOOXXXXXXXXXXXXXXXXXXXXXXXXXXXXXOOOOOOYXXXXOOOXXXXXXXXXXXXXXXXXXOOXXXXXXOXXXXXXXXXXXXXXXXXXXXXXXXXXXXXXXXXXXX
XXXOOOOOOXXXXXOOXXXXXXXXXXXXXXXXXXXXXXXXXXXXXXOOOOOOXXXXXXOOOXXXXXXXXXXXXXXXXOOXXXXXXOOXXXXXXXXXXXXXXXXXXXXXXXXXXXXXXXXXXXX
XXXOOOOOOXXXXOOXXXXXXXXXXXXXXXXXXXXXXXXXXXXXXXOOOOOOXXXXXXXXOOOXXXXXXXXO1OOOOOXXXXXXOOXXXXXXXXXXXXXXXXXXXXXXXXXXXXXXXXXXXXX
XXXOOOOOOXXXOOXXXXXXXXXXXXXXXXXXXXXXXXXXXXXXXXOOOOOOXXXXXXXXXOOXXXXXXXOO1OOOOXXXXXXXOOXXXXXXXXXXXXXXXXXXXXXXXXXXXXXXXXXXXXX
XXXOOOOOOXXOOOXXXXXXXXXXXXXXXXXXXXXXXXXXXXXXXXOOOOOOXXXXXXXXXXOOXXXXXXOOXXXXXXXXXXXOOXXXXXXXXXXXXXXXXXXXXXXXXXXXXXXXXXXXXXX
XXXOOOOOOXXOOOXXXXXXXXXXXXXXXXXXXXXXXXXXXXXXXXOOOOOOXXXXXXXXXXOOXXXXXXOXXXXXXXXXXXXOXXXXXXXXXXXXXXXXXXXXXXXXXXXXXXXXXXXXXXX
XXXOOOOOOXXOOOXXXXXXXXXXXXXXXXXXXXXXXXXXXXXXXXOOOOOOXXXXXXXXXXXOOXXXXOOXXXXXXXXXXXXOOOXXXXXXXXXXXXXXXXXXXXXXXXXXXXXXXXXXXXX
XXXOOOOOOXXOOOXXXXXXXXXXXXXXXXXXXXXXXXXXXXXXXXOOOOOOXXXXXXXXXXXXOOXXOOXXXXXXXXXXXXXXOOOXXXXXXXXXXXXXXXXXXXXXXXXXXXXXXXXXXXX
XXXOOOOOOXXOOOXXXXXXXXXXXXXXXXXXXXXXXXXXXXXXXXOOOOOOXXXXXXXXXXXXXOOOOXXXXXXXXXXXXXXXYYOYYXXXXXXXXXXXXXXXXXXXXXXXXXXXXXXXXXX
XXXOOOOOOXXOOOXXXXXXXXXXXXXXXXXXXXXXXXXXXXXXXXOOOOOOXXXXXXXXXXXXXXXXXXXXXXXXXXXXXXYYYYOOYXXXXXXXXYYYYXXXXXXXXXXXXXXXXXXXXXX
XXXOOOOOOXXOOOXXXXXXXXXXXXXXXXXXXXXXXXXXXXXXXXOOOOOOXXXXXXXXXXXXXXXXXXXXXXXXXXXXYYYOOOOOYYXXXXXXYYOOYYYXXXXXXXXXXXXXXXXXXXX
XXXOOOOOOXXOOOXXXXXXXXXXXXXXXXXXXXXXXXXXXXXXXXOOOOOOXXXXXXXXXXXXXXXXXXXXXXXXXXXYYOOOOOOOOYYXXXXXOOOOOYYYXXXXXXXXXXXXXXXXXXX
XXXOOOOOOXXOOOXXXXXXXXXXXXXXXXXXXXXXXXXXXXXXXXOOOOOOXXXXXXXXXXXXXXXXXXXXXXXXXXYYOOOOOOOOOOOOOOOOOOOOOOYYYYXXXXXXXXXXXXXXXXX
XXXOOOOOOXXOOOXXXXXXXXXXXXXXXXXXXXXXXXXXXXXXXXOOOOOOXXXXXXXXXXXXXXXXXXXXXXXXXXYOOOOOOOOOOOOOOOOOOOOOOOOOYYYXXXXXXXXXXXXXXXX
XXXOOOOOOXXOOOXXXXXXXXXXXXXXXXXXXXXXXXXXXXXXXXOOOOOOXXXXXXXXXXXXXXXXXXXXXXXXXXOOOOOOOOOOOOOOOOOOOOOOOOOOOOYYYXXXXXXXXXXXXXX
XXXOSOSOSXXOSOXXXXXXXXXXXXXXXXXXXXXXXXXXXXXXXXOOOOOOXXXXXXXXXXXXXXXXXXXXXXXXXXOOOOOOOOOOOOOOOOOOOOOOOOOOOOOOYYYXXXXXXXXXXXX
XXXSOSOSOXXSOSXXXXXXXXXXXXXXXXXXXXXXXXXXXXXXXXOOOOOOXXXXXXXXXXXXXXXXXXXXXXXXXXOOOOOOOOOOOOOOOOOOOOOOOOOOOOOOOYYXXXXXXXXXXXX
XXXFFFFFFXXFFFXXXXXXXXXXXXXXXXXXXXXXXXXXXXXXXXOOOOOOXXXXXXXXXXXXXXXXXXXXXXXXXOOOOOOOOOOOOOOOOOOOOOOOOOOOOOOOOOYXXXXXXXXXXXX
XXXOOOOOOXXOOOXXXXXXXXXXXXXXXXXXXXXXXXXXXXXXXXOOOOOOXXXXXXXXXXXXXXXXXXXXXXXXXOOOOOOXXXXXYOOOOOOOOYYXXXXXOOOOOOYXXXXXXXXXXXX
XXXOOOOOOXXOOOXXXXXXXXXXXXXXXXXXXXXXXXXXXXXXXXOOOOOOXXXXXXXXXXXXXXXXXXXXXXXXOOOOOOXXXXXXYYYOOOOOYYXXXXXXXXOOOOOXXXXXXXXXXXX
XXXOOOOOOXXOOOXXXXXXXXXXXXXXXXXXXXXXXXXXXXXXXXOOOOOOXXXXXXXXXXXXXXXXXXXXXXXXOOOOOXXXXXXXXYYYYOOOOOOXXXXXXXXXOOOOXXXXXXXXXXX
XXXOOOOOOXXOOOXXXXXXXXXXXXXXXXXXXXXXXXXXXXXXXXOOOOOOXXXXXXXXXXXXXXXXXXXXXXXOOOOOXXXXXXXXXXXXYYYYYOOOXXXXXXXXXOOOOXXXXXXXXXX
XXXOOOOOOXXOOOXXXXXXXXXXXXXXXXXXXXXXXXXXXXXXXXOOOOOOXXXXXXXXXXXXXXXXXXXXXXOOOOOOXXXXXXXXXXXXXXXXXXOOXXXXXXXXXXOOOOXXXXXXXXX
XXXOOOOOOXXOOOXXXXXXXXXXXXXXXXXXXXXXXXXXXXXXXXOOOOOOOXXXXXXXXXXXXXXXXXXXXXOOOOOOXXXXXXXXXXXXXXXXXXXOOXXXXXXXXXXOOOOXXXXXXXX
XXXOOOOOOXXOOOXXXXXXXXXXXXXXXXXXXXXXXXXXXXXXXYOOOOOOOOXXXXXXXXXXXXXXXXXXXOOOOOOXXXXXXXXXXXXXXXXXXXXOOXXXXXXXXXXXOOOOXXXXXXX
XXXOOOOOOXXOOOXXXXXXXXXXXXXXXXXXXXXXXXXXXXXXXYOOOOOOOOOOXXXXXXXXXXXXXXXXOOOOOOOXXXXXXXXXXXXXXXXXXXXXOOXXXXXXXXXXOOOOXXXXXXX
XXXOOOOOOXXOOOXXXXXXXXXXXXXXXXXXXXXXXXXXXXXXXYOOOOOOOOOOOOXXXXXXXXXXXXXOOOOOOOYXXXXXXXXXXXXXXXXXXXXXXOOXXXXXXXXXOOOOOXXXXXX
XXXOOOOOOXXXOOXXXXXXXXXXXXXXXXXXXXXXXXXXXXXXXYOOYOOOOOOOOOOXXXXXXXXXXXOOOOOOOYYXXXXXXXXXXXXXXXXXXXXXXXOXXXXXXXXXXOOOOXXXXXX
XXXOOOOOOXXXOOOXXXXXXXXXXXXXXXXXXXXXXXXXXXXXXYOOOOOOOOOOOOOOOOOO2OOOOOOOOOOOYYXXXXXXXXXXXXXXXXXXXXXXXXOOXXXXXXXXXXOOOXXXXXX
XXXOOOOOOXXXXOOOXXXXXXXXXXXXXXXXXXXXXXXXXXXXXOOOOOYYYYOOOOOOOOOO2OOOOOOOOOOYYYXXXXXXXXXXXXXXXXXXXXXXXXXOOXXXXXXXXXOOOOXXXXX
XXXOOOOOOXXXXOOOXXXXXXXXXXXXXXXXXXXXXXXXXXXXXOOOOYYYYYYYOOOOOOOO2OOOOOOOOOYYYYXXXXXXXXXXXXXXXXXXXXXXXXXXOOXXXXXXXXOOOOXXXXX
XXXOOOOOOXXXXXOOXXXXXXXXXXXXXXXXXXXXXXXXXXXXXOOOYYYYYYYYYOOOOOOO2OOOOOOOYYYYXXXXXXXXXXXXXXXXXXXXXXXXXXXXOOXXXXXXXXXOOOOXXXX
XXYOOOOOOXXXXXOOOXXXXXXXXXXXXXXXXXXXXXXXXXXXOOOYYYXXXXXYYYYOOOOO2OOOOOOYYYYXXXXXXXXXXXXXXXXXXXXXXXXXXXXXXOOXXXXXXXXXOOOXXXX
XXYOOOOOOXXXXXXOOOXXXXXXXXXXXXXXXXXXXXXXXXXOOOOXXXXXXXXXYYYYYXXXXXYYYYYYYYXXXXXXXXXXXXXXXXXXXXXXXXXXXXXXXXOOXXXXXXXXOOOXXXX
XXYOOOOOOXXXXXXXOOOXXXXXXXXXXXXXXXXXXXXXXXOOOOOXXXXXXXXXXXXXXXXXXXXXXXXXXXXXXXXXXXXXXXXXXXXXYXXXXXXXXXXXXXOOXXXXXXXXXOOOXXX
XYYOOOOOOOXXXXXXXOOOXXXXXXXXXXXXXXXXXXXXXOOOXXOOXXXXXXXXXXXXXXXXXXXXXXXXXXXXXXXXXXXXXXXXXXXYXXXXXXXXXXXXXXOOXXXXXXXXXOOOXXX
XYYYOOOOOOXXXXXXXXOOOOOXXXXXXXXXXXXXXXXXOOOXXXOOXXXXXXXXXXXXXXXXXXXXXXXXXXXXXXXXXXXXXXYYYYYXXXXXXXXXXXXXXXOOXXXXXXXXXOOOXXX
XYYYOOOOOOXXXXXXXXXOOOOOOOXXXXXXXXXXXXOOOOXXXXOOOXXXXXXXXXXXXXXXXXXXXXXXXXXXXXXXXXXXXXYXXXYXXXXXXXXXXXXXXXXOXXXXXXXXXOOOXXX
XYYYOOOOOOOXXXXXXXXXOOOOOOOOOOOOOOOOOOOOXXXXXXXOOOXXXXXXXXXXXXXXXXXXXXXXXXXXXXXXXXXXXXYXYXYXXXXXXXXXXXXXXXXOXXXXXXXXX111XXX
XXYYYOOOOOOOXXXXXXXXXOOOOOOOOOOOOOOOOOOOOOOOOOOOOOOXXXXXXXXXXXXXXXXXXXXXXXXXXXXXXXXXXXYXXXYXXXXXXXXXXXXXXXX2XXXXXXXXXOOOXXX
XXYYYOOOOOOOOOOOOOOOOOOOOOOOOOOOOOOOOOOOOOOOOOOOOOOOXXXXXXXXXXXXXXXXXXXXXXXXXXXXXXXXXXYYYYYXXXXXXXXXXXXXXXXOXXXXXXXXXOOOXXX
XXXYYYOOOOOOOOOOOOOOOOOOOOOOOOOOOOOOOOOOOOOOOOOOOOOOOOXXXXXXXXXXXXXXXXXXXXXXXXXXXXXXXXXXYXXXXXXXXXXXXXXXXXXOXXXXXXXXXOOOXXX
XXXXYYOOOOOOOOOOOOOOOOOOOOOOOOOOOOOOOOOOOOOOOOOOOOOOOOOOXXXXXXXXXXXXXXXXXXXXXXXXXXXXXXXXYXXXXXXXXXXXXXXXXXXOXXXXXXXXXOOOXXX
XXXXYYYOOOOOOOOOOOOOOOOOOOOOOOOOOOOOOOOOOOOOOOOOOOOOOOOOOOOOXXXXXXXXXXXXXXXXXXXXXXXXXXXXXXXXXXXXXXXXXXXXXXXOXXXXXXXXXOOOXXX
XXXXXYYYOOOOOOOOOOOOOOOOOOOOOOOOOOOOOOOOOOOOOOOOOOOOOOOOOOOOOOXXXXXXXYYYYYYYXXXXXXXXXXXXXXXXXXXXXXXXXXXXXXOOXXXXXXXXXOOOYXX
XXXXXXYYYOOOOOOOOOOOOOOOOOOOOOOOOOOOOOOOOOOOOOOOOOOOOOOOOOOOOOOOXYYYYYYOOOOOXXXXXXXXXXXXXXXXXXXXXXXXXXXXXXOOXXXXXXXXXOOOYYX
XXXXXXXYYYYOOOOOOOOOOOOOOOOOOOOOOOOOOOOOOOOOOOOOOOOOOOOOOOOOOOOOOOYYOOOOOOOOOXXXXXXXXXXXXXXXXXXXXXXXXXXXXOOOXXXXXXXXXOOOOYX
XXXXXXXXXXXXXXXXXXXXXXXXXXXXXXXXXXXXXXXXXXXXXXXXOOOOOOOOOOOOOOOOOOOOOOOOOOOOOOOXXXXXXXXXXXXXXXXXXXXXXXXXOOOXXXXXXXXXXOOOOYX
XXXXXXXXXXXXXXXXXXXXXXXXXXXXXXXXXXXXXXXXXXXXXXXXXXXXXOOOOOOOOOOOOOOOOOOOOYYYOOOOOOOOOOOXXXXXXXXXXXXXXXXXOOXXXXXXXXXXXOOOOYX
XXXXXXXXXXXXXXXXXXXXXXXXXXXXXXXXXXXXXXXXXXXXXXXXXXXXXXOOOOOOOOOOOOOOOOOOOOYYYYYOOOYOOOOOOXXXXXXXXXXXXXXXOOXXXXXXXXXXOOOOOYX
XXXXXXXXXXXXXXXXXXXXXXXXXXXXXXXXXXXXXXXXXXXXXXXXXXXXXXOOOXXOOOOOOOOOOOOOOOOOOYYYYOYYXXXOOOOOXXXXXXXXXXXXOOXXXXXXXXXXOOOOYYX
XXXXXXXXXXXXXXXXXXXXXXXXXXXXXXXXXXXXXXXXXXXXXXXXXXXXXXXXOOXXOOOOOOOOOOOOOOOOOOOYYY3YYX3OOOOOXXXXXXXXXXXXOOXXXXXXXXOOOOOOYYX
XXXXXXXXXXXXXXXXXXXXXXXXXXXXXXXXXXXXXXXXXXXXXXXXXXXXXXXXXOOXXOOOOOOOOOOOOOYYOOOOYYY3Y3XXOOOOOOOOOOXXXXXXOOXXXXXXXXOOOOOOYYX
XXXXXXXXXXXXXXXXXXXXXXXXXXXXXXXXXXXXXXXXXXXXXXXXXXXXXXXXXXOOXXOOOOOOOOOOOOOYYYOO3YYY3YYX3XXOOOOOOOXXXXXOOOXXXXXXXOOOOOOYYXX
XXXXXXXXXXXXXXXXXXXXXXXXXXXXXXXXXXXXXXXXXXXXXXXXXXXXXXXXXXOOXXOOXXXXOOOOOOOOOOYY33Y3Y3Y3XXXXXXXXXOOOOOOOOXXXXXXXOOOOOOYYYXX
XXXXXXXXXXXXXXXXXXXXXXXXXXXXXXXXXXXXXXXXXXXXXXXXXXXXXXXXXXXOOXXOOOXXXXXXXXXOOO3YYY3YYY3YYXXXXXXXXXOOOOOOXXXXXXXOOOOOOYYYYXX
XXXXXXXXXXXXXXXXXXXXXXXXXXXXXXXXXXXXXXXXXXXXXXXXXXXXXXXXXXXXOOXXXOOXXXXXXXXXXYY3Y3Y3Y3Y3YYXXXXXXXXXXXXXXXXXXXXXOOOOOYYYYXXX
XXXXXXXXXXXXXXXXXXXXXXXXXXXXXXXXXXXXXXXXXXXXXXXXXXXXXXXXXXXXXOOOXXOOOXXXXXXXXXYY3YYY3YYY3YXXXXXXXXXXXXXXXXXXXXOOOOOOYYYXXXX
XXXXXXXXXXXXXXXXXXXXXXXXXXXXXXXXXXXXXXXXXXXXXXXXXXXXXXXXXXXXXXXOOXXXOOOOOXXXXXX3Y3Y3Y3YYYOOXXXXXXXXXXXXXXXXXXXOOOOOYYYXXXXX
XXXXXXXXXXXXXXXXXXXXXXXXXXXXXXXXXXXXXXXXXXXXXXXXXXXXXXXXXXXXXXXXOOOXXXXXOOOOOOOXYY3YYY3YYOOOXXXXXXXXXXXXXXXXOOOOOOYYYXXXXXX
XXXXXXXXXXXXXXXXXXXXXXXXXXXXXXXXXXXXXXXXXXXXXXXXXXXXXXXXXXXXXXXXXXOOOXXXXXXXXXXXX3Y3YYYOOOOOOOXXXXXXXXXXXXXOOOOOOYYYXXXXXXX
XXXXXXXXXXXXXXXXXXXXXXXXXXXXXXXXXXXXXXXXXXXXXXXXXXXXXXXXXXXXXXXXXXXOOOOXXXXXXXOO3XYY3YYOOOOOOOXXXXXXXXXXXOOOOOOOYYYXXXXXXXX
XXXXXXXXXXXXXXXXXXXXXXXXXXXXXXXXXXXXXXXXXXXXXXXXXXXXXXXXXXXXXXXXXXXXOOOOOOOOOOOOXXXYYOOOOOOOOOOXXXXXXOOOOOOOOOOYYYXXXXXXXXX
XXXXXXXXXXXXXXXXXXXXXXXXXXXXXXXXXXXXXXXXXXXXXXXXXXXXXXXXXXXXXXXXXXXXXXXXXXXXXXXXXXXXYOOOOOOOOOOOOOOOOOOOOOOOOYYYYXXXXXXXXXX
XXXXXXXXXXXXXXXXXXXXXXXXXXXXXXXXXXXXXXXXXXXXXXXXXXXXXXXXXXXXXXXXXXXXXXXXXXXXXXXXXXXXXYOOOOOOOOOOOOOOOOOOOOOOYYYYXXXXXXXXXXX
XXXXXXXXXXXXXXXXXXXXXXXXXXXXXXXXXXXXXXXXXXXXXXXXXXXXXXXXXXXXXXXXXXXXXXXXXXXXXXXXXXXXXYYYOOOOOOOOOOOOOOOOOYYYYYYXXXXXXXXXXXX
XXXXXXXXXXXXXXXXXXXXXXXXXXXXXXXXXXXXXXXXXXXXXXXXXXXXXXXXXXXXXXXXXXXXXXXXXXXXXXXXXXXXXXXYYYOOOOOOOOOOOOYYYYYYYXXXXXXXXXXXXXX
XXXXXXXXXXXXXXXXXXXXXXXXXXXXXXXXXXXXXXXXXXXXXXXXXXXXXXXXXXXXXXXXXXXXXXXXXXXXXXXXXXXXXXXXYYYYYOOOOOOOYYYYYYXXXXXXXXXXXXXXXXX
XXXXXXXXXXXXXXXXXXXXXXXXXXXXXXXXXXXXXXXXXXXXXXXXXXXXXXXXXXXXXXXXXXXXXXXXXXXXXXXXXXXXXXXXXXXYYYYYYYYYYYXXXXXXXXXXXXXXXXXXXXX
XXXXXXXXXXXXXXXXXXXXXXXXXXXXXXXXXXXXXXXXXXXXXXXXXXXXXXXXXXXXXXXXXXXXXXXXXXXXXXXXXXXXXXXXXXXXYYYYYYYYXXXXXXXXXXXXXXXXXXXXXXX
XXXXXXXXXXXXXXXXXXXXXXXXXXXXXXXXXXXXXXXXXXXXXXXXXXXXXXXXXXXXXXXXXXXXXXXXXXXXXXXXXXXXXXXXXXXXXXXXXXXXXXXXXXXXXXXXXXXXXXXXXXX





