PXXXXXXXXXXXXXXXXXXXXXXXXXXXXXXXXXXXXXXXXXXXXXXXXXXXXXXXXXXXXXXXXXXXXXXXXXXXXXXXXXXXXXXXXXXXXXXXXXXXXXXXXXXXXXXXXXXXXXXXXXX
PXXXXXXXXXXYYYYYYYYYXXXXXXXXXXXXXXXXXXXXXXXXXXXXXXXXXXXXXXXXXXXXXXXXXXXXXXXXXXXXXXXXXXXXXXXXXXXXXXXXXXXXXXXXXXXXXXXXXXXXXXX
PXXXXXXYYYYYYOOOOOOOOOOOOOXXXXXXXXXXXYYYYYYYYYYXXXXXXXXXXXXXXXXXXXXXXXXXXXXXXXXXXXXXXXXXXXXXXXXXXXXXXXXXXXXXXXXXXXXXXXXXXXX
PXXXXXYYYYYOOOOOOOOOOOOOOOOOOOOOOOOOOOOOOOYYYYYYXXXXXXXXXXXXXXXXXXXXXXXXXXXXXXXXXXXXXXXXXXXXXXXXXXXXXXXXXXXXXXXXXXXXXXXXXXX
PXXXYYYYOOOOOOOOOOOOOOOOOOOOOOOOOOOOOOOOOOOOOYYYYYXXXXXXXXXXXXXXXXXXXXXXXXXXXXXXXXXXXXXXXXXXXXXXXXXXXXXXXXXXXXXXXXXXXXXXXXX
PXXYYYYYOOOOOOOOOOOOOOOOOOOOOOOOOOOOOOOOOOOOOOOYYYYXXXXXXXXXXXXXXXXXXXXXXXXXXXXXXXXXXXXXXXXXXXXXXXXXXXXXXXXXXXXXXXXXXXXXXXX
PXXYYYOOOOOOOOOOOOOOOOOOOOOOOOOOOOOOOOOOOOOOOOOOOOYYXXXXXXXXXXXXXXXXXXXXXXXXXXXXXXXXXXXXXXXXXXXXXXXXXXXXXXXXXXXXXXXXXXXXXXX
PXXYYOOOOOOOOOOOOOOOOOOOOOXXXXXXXXOOOOOOOOOOOOOOOOOOOXXXXXXXXXXXXXXXXXXXXXXXXXXXXXXXXXXXXXXXXXXXXXXXXXXXXXXXXXXXXXXXXXXXXXX
PXXYOOOOOOOOOOOOOOOOOOOOXXXXXXXXXXXXXOOOOOOOOOOOOOOOOOOXXXXXXXXXXXXXXXXXXXXXXXXXXXXXXXXXXXXXXXXXXXXXXXXXXXXXXXXXXXXXXXXXXXX
XXXYOOOOOOOOXXXXXXOOOOXXXXXXXXXXXXXXXXXXOOOOOOOOOOOYYOOOXXXXXXXXXXXXXXXXXXXXXXXXOOOOOXXXXXXXXXXXXXXXXXXXXXXXXXXXXXXXXXXXXXX
XXXYOOOOOOOXXXXXXXOOXXXXXXXXXXXXXXXXXXXXXXOOOOOOOOOYYXOOOXXXXXXXXXXXXXXXXXXXXXXOOOOXOOXXXXXXXXXXXXXXXXXXXXXXXXXXXXXXXXXXXXX
XXXOOOOOOOXXXXXXXOOXXXXXXXXXXXXXXXXXXXXXXXXXOOOOOOOYYXXXOOXXXXXXXXXXXXXXXXXXXXOOXXXXXOOXXXXXXXXXXXXXXXXXXXXXXXXXXXXXXXXXXXX
XXXOOOOOOOXXXXXXOOXXXXXXXXXXXXXXXXXXXXXXXXXXXOOOOOOOYXXXOOXXXXXXXXXXXXXXXXXXXXOOXXXXXXOXXXXXXXXXXXXXXXXXXXXXXXXXXXXXXXXXXXX
XXXOOOOOOOXXXXXOOXXXXXXXXXXXXXXXXXXXXXXXXXXXXXOOOOOOYXXXXOOOXXXXXXXXXXXXXXXXXXOOXXXXXXOXXXXXXXXXXXXXXXXXXXXXXXXXXXXXXXXXXXX
XXXOOOOOOXXXXXOOXXXXXXXXXXXXXXXXXXXXXXXXXXXXXXOOOOOOXXXXXXOOOXXXXXXXXXXXXXXXXOOXXXXXXOOXXXXXXXXXXXXXXXXXXXXXXXXXXXXXXXXXXXX
XXXOOOOOOXXXXOOXXXXXXXXXXXXXXXXXXXXXXXXXXXXXXXOOOOOOXXXXXXXXOOOXXXXXXXXO9OOOOOXXXXXXOOXXXXXXXXXXXXXXXXXXXXXXXXXXXXXXXXXXXXX
XXXOOOOOOXXXOOXXXXXXXXXXXXXXXXXXXXXXXXXXXXXXXXOOOOOOXXXXXXXXXOOXXXXXXXOO9OOOOXXXXXXXOOXXXXXXXXXXXXXXXXXXXXXXXXXXXXXXXXXXXXX
XXXOOOOOOXXOOOXXXXXXXXXXXXXXXXXXXXXXXXXXXXXXXXOOOOOOXXXXXXXXXXOOXXXXXXOOXXXXXXXXXXXOOXXXXXXXXXXXXXXXXXXXXXXXXXXXXXXXXXXXXXX
XXXOOOOOOXXOOOXXXXXXXXXXXXXXXXXXXXXXXXXXXXXXXXOOOOOOXXXXXXXXXXOOXXXXXXOXXXXXXXXXXXXOXXXXXXXXXXXXXXXXXXXXXXXXXXXXXXXXXXXXXXX
XXXOOOOOOXXOOOXXXXXXXXXXXXXXXXXXXXXXXXXXXXXXXXOOOOOOXXXXXXXXXXXOOXXXXOOXXXXXXXXXXXXOOOXXXXXXXXXXXXXXXXXXXXXXXXXXXXXXXXXXXXX
XXXOOOOOOXXOOOXXXXXXXXLXXXXXTTTTTTTTTTTXXXXXXXOOOOOOXXXXXXXXXXXXOOXXOOXXXXXXXXXXXXXXOOOXXXXXXXXXXXXXXXXXXXXXXXXXXXXXXXXXXXX
XXXOOOOOOXXOOOXXXXXXXTLTXXXXXXXXXTXXXXXXXXXXXXOOOOOOXXXXXXXXXXXXXOOOOXXXXXXXXXXXXXXXYYOYYXXXXXXXXXXXXXXXXXXXXXXXXXXXXXXXXXX
XXXOOOOOOXXOOOXXXXXXXXTLLLLLLLLLLLLLXXXXXXXXXXOOOOOOXXXXXXXXXXXXXXXXXXXXXXXXXXXXXXYYYYOOYXXXXXXXXYYYYXXXXXXXXXXXXXXXXXXXXXX
XXXOOOOOOXXOOOXXXXXXXTXTXLLLLLLLLLWWLXXXXXXXXXOOOOOOXXXXXXXXXXXXXXXXXXXXXXXXXXXXYYYOOOOOYYXXXXXXYYOOYYYXXXXXXXXXXXXXXXXXXXX
XXXOOOOOOXXOOOXXXXXXXXXXXXXXXLLLLLLWLXXXXXXXXXOOOOOOXXXXXXXXXXXXXXXXXXXXXXXXXXXYYOOOOOOOOYYXXXXXOOOOOYYYXXXXXXXXXXXXXXXXXXX
XXXOOOOOOXXOOOXXXXXXXXXXXXXXXXXLLLLLLXXXXXXXXXOOOOOOXXXXXXXXXXXXXXXXXXXXXXXXXXYYOOOOOOOOOOOOOOOOOOOOOOYYYYXXXXXXXXXXXXXXXXX
XXXOOOOOOXXOOOXXXXXXXXXXXXXXXXXXLLLLXXXXXXXXXXOOOOOOXXXXXXXXXXXXXXXXXXXXXXXXXXYOOOOOOOOOOOOOOOOOOOOOOOOOYYYXXXXXXXXXXXXXXXX
XXXOOOOOOXXOOOXXXXXXXXXXXXXXXXXXVXVXXXXXXXXXXXOOOOOOXXXXXXXXXXXXXXXXXXXXXXXXXXOOOOOOOOOOOOOOOOOOOOOOOOOOOOYYYXXXXXXXXXXXXXX
XXXOSOSOSXXOSOXXXXXXXXXXXXXXXXXVVVVVXXXXXXXXXXOOOOOOXXXXXXXXXXXXXXXXXXXXXXXXXXOOOOOOOOOOOOOOOOOOOOOOOOOOOOOOYYYXXXXXXXXXXXX
XXXSOSOSOXXSOSXXXXXXXXXXXXXXXXXXXXXXXXXXXXXXXXOOOOOOXXXXXXXXXXXXXXXXXXXXXXXXXXOOOOOOOOOOOOOOOOOOOOOOOOOOOOOOOYYXXXXXXXXXXXX
XXXFFFFFFXXFFFXXXXXXXXXXXXXXXXXXXXXXXXXXXXXXXXOOOOOOXXXXXXXXXXXXXXXXXXXXXXXXXOOOOOOOOOOOOOOOOOOOOOOOOOOOOOOOOOYXXXXXXXXXXXX
XXXOOOOOOXXOOOXXXXXXXXXXXXXXXXXXXXXXXXXXXXXXXXOOOOOOXXXXXXXXXXXXTGGGTXXXXXXXXOOOOOOXXXXXYOOOOOOOOYYXXXXXOOOOOOYXXXXXXXXXXXX
XXXOOOOOOXXOOOXXXXXXXXXXXXXXXXXXXXXXXXXXXXXXXXOOOOOOXXXXXXXXXXXXTGGGTXXXXXXXOOOOOOXXXXXXYYYOOOOOYYXXXXXXXXOOOOOXXXXXXXXXXXX
XXXOOOOOOXXOOOXXXXXXXXXXXXXXXXXXXXXXXXXXXXXXXXOOOOOOXXXXXXXXXXXXXGVGXXXXXXXXOOOOOXXXXXXXXYYYYOOOOOOXXXXXXXXXOOOOXXXXXXXXXXX
XXXOOOOOOXXOOOXXXXXXXXXXXXXXXXXXXXXXXXXXXXXXXXOOOOOOXXXXXXXXXXXXTGVGTXXXXXXOOOOOXXXXXXXXXXXXYYYYYOOOXXXXXXXXXOOOOXXXXXXXXXX
XXXOOOOOOXXOOOXXXXXXXXXXXXXXXXXXXXXXXXXXXXXXXXOOOOOOXXXXXXXXXXXXTGGGTXXXXXOOOOOOXXXXXXXXXXXXXXXXXXOOXXXXXXXXXXOOOOXXXXXXXXX
XXXOOOOOOXXOOOXXXXXXXXXXXXXXXXXXXXXXXXXXXXXXXXOOOOOOOXXXXXXXXXXXXXGXXXXXXXOOOOOOXXXXXXXXXXXXXXXXXXXOOXXXXXXXXXXOOOOXXXXXXXX
XXXOOOOOOXXOOOXXXXXXXXXXXXXXXXXXXXXXXXXXXXXXXYOOOOOOOOXXXXXXXXXX55555XXXXOOOOOOXXXXXXXXXXXXXXXXXXXXOOXXXXXXXXXXXOOOOXXXXXXX
XXXOOOOOOXXOOOXXXXXXXXXXXXXXXXXXXXXXXXXXXXXXXYOOOOOOOOOOXXXXXXXXZZZZZXXXOOOOOOOXXXXXXXXXXXXXXXXXXXXXOOXXXXXXXXXXOOOOXXXXXXX
XXXOOOOOOXXOOOXXXXXXXXXXXXXXXXXXXXXXXXXGXXXXXYOOOOOOOOOOOOXXXXZZZZZZZXXOOOOOOOYXXXXXXXXXXXXXXXXXXXXXXOOXXXXXXXXXOOOOOXXXXXX
XXXOOOOOOXXXOOXXXXXXXXXXXXXXXXXXXXXXXXGGGXXXXYOOYOOOOOOOOOOXXZZZZZZZZXOOOOOOOYYXXXXXXXXXXXXXXXXXXXXXXXOXXXXXXXXXXOOOOXXXXXX
XXXOOOOOOXXXOOOXXXXXXXXXXXXXXXXXXXXXXGgGGGXXXYOOOOOOOOOOOOOOOZZZZZZZZZOOOOOOYYXXXXXXXXXXXXXXXXXXXXXXXXOOXXXXXXXXXXOOOXXXXXX
XXXOOOOOOXXXXOOOXXXXXXXXXXXXXXXXXXXXXXGGGGGXXOOOOOYYYYOOOOOOOOZZZZZZZZZOOOOYYYXXXXXXXXXXXXXXXXXXXXXXXXXOOXXXXXXXXXOOOOXXXXX
XXXOOOOOOXXXXOOOXXXXXXXXXXXXXXXXGGGXXXVGGGGGXOOOOYYYYYYYOOOOOOZTTTZZZZZ666YYYYXXXXXXXXXXXXXXXXXXXXXXXXXXOOXXXXXXXXOOOOXXXXX
XXXOOOOOOXXXXXOOXXXXXXXXXXXXXXXGWGGXXVXXGGGGGZZZYYYYYYYYZZOOOOOT5TOZZZZZYYYYXXXXXXXXXXXXXXXXXXXXXXXXXXXXOOXXXXXXXXXOOOOXXXX
XXYOOOOOOXXXXXOOOXXXXXXXXXXXXXGWWGGXVXXXXGGGGZZZZZZZZZZZZZZOOOOO5OOOZZZYYYYXXXXXXXXXXXXXXXXXXXXXXXXXXXXXXOOXXXXXXXXXOOOXXXX
XXYOOOOOOXXXXXXOOOXXXXXXXXXXXXGGGGGVXXXXXXGGZZZZZZZZZZZZZZZYYXXX5XYYYYYYYYXXXXXXXXXXXXXXXXXXXXXXXXXXXXXXXXOOXXXXXXXXOOOXXXX
XXYOOOOOOXXXXXXXOOOXXXXXXXXXXXGGGGGGGGGGGGGOZZZZZZZZZZZZZZZXX5XX5XX5XXXXXXXXXXXXXXXXXXXXXXXXYXXXXXXXXXXXXXOOXXXXXXXXXOOOXXX
XYYOOOOOOOXXXXXXXOOOXXXXXXXXXXXTTXXXXTTXTTOOXXOZZZZZZZZZZXXXXX5G5G5XXXXXXXXXXXXXXXXXXXXXXXXYXXXXXXXXXXXXXXOOXXXXXXXXXOOOXXX
XYYYOOOOOOXXXXXXXXOOOOOXXXXXXXXXXXXXXXXXOOOXXXOOXXZZZZZZXXXXXXGG5VGXXXXXXXXXXXXXXXXXXXYYYYYXXXXXXXXXXXXXXXOOXXXXXXXXX28OXXX
XYYYOOOOOOXXXXXXXXXOOOOOOOXXXXXXXXXXXXOOOOXXXXOOOXXXZZZXXXXXXXGG5VGXXXXXXXXXXXXXXXXXXXYXXXYXXXXXXXXXXXXXXXXOXXXXXXNNNNNNOXX
XYYYOOOOOOOXXXXXXXXXOOOOOOOOOOOOOOOOOOOOXXXXXXXOOOXXXXXXXXXXXXGG5VGXXXXXXXXXXXXXXXXXXXYXYXYXXXXXXXXXXXXXXXXOXXXXXXNNLNNWNXX
XXYYYOOOOOOOXXXXXXXXXOOOOOOOOOOOOOOOOOOOOOONNNNNNNN28XXXXXXXXX5GGG5XXXXXXXXXXXXXXXXXXXYXXXYXXXXXXXXXXXXXXXX1XXXXXXNLLLNWWNX
XXYYYOOOOOOOOOOOOOOOOOOOOOOOOOOOOOOOOOOOOOOOVVOOOOOLLLXXXXXXX5XXXXX5XXXXXXXXXXXXXXXXXXYYYYYXXXXXXXXXXXXXXXXOXXXXXXNNLNNNNNX
XXXYYYOOOOOOOOOOOOOOOOOOOOOOOOOOOOOOOOOOOOOLLLLLLLLLLWLXXXXXXXXXXXXXXXXXXXXXXXXXXXXXXXXXYXXXXXXXXXXXXXXXXXXOXXXXXXNNNNNNNNX
XXXXYYOOOOOOOOOOOOOOOOOOOOOOOOOOOOOOOOOOOOOLLLLLLLLLLWWLXXXXXXXXXXXXXXXXXXXXXXXXXXXXXXXXYXXXXXXXXXXXXXXXXXXOXXXXXXXTTOOTTXX
XXXXYYYOOOOOOOOOOOOOOOOOOOOOOOOOOOOOOOOOOOOLLLLLLLLLLLLLOOOOXXXXXXXXXXXXXXXXXXXXXXXXXXXXXXXXXXXXXXXXXXXXXXXOXXXXXXXXXL77XXX
XXXXXYYYOOOOOOOOOOOOOOOOOOOOOOOOOOOOOOOOOOOLLLLLLLLLLLLLOOOOOOXXXXXXXYYYYYYYXXXXXXXXXXXXXXXXXXXXXXXXXXXXXXOOXXXXXXXXX7L7YXX
XXXXXXYYYOOOOOOOOOOOOOOOOOOOOOOOOOOOOOOOOOOOTTOTTOOOOTTOOOOOOOOOXYYYYYYOOOOOXXXXXXXXXXXXXXXXXXXXXXXXXXXXXXOOXXXXXXXXX77LYYX
XXXXXXXYYYYOOOOOOOOOOOOOOOOOOOOOOOOOOOOOOOOOOOOOOOOOOOOOOOOOOOOOOOYYOOOOOOOOOXXXXXXXXXXXXXXXXXXXXXXXXXXXXOOOXXXXXXXXXOOOOYX
XXXXXXXXXXXXXXXXXXXXXXXXXXXXXXXXXXXXXXXXXXXXXXXXOOOOOOOOOOOOOOOOOOOOOOOOOOOOOOOXXXXXXXXXXXXXXXXXXXXXXXXXOOOXXXXXXXXXXOOOOYX
XXXXXXXXXXXXXXXXXXXXXXXXXXXXXXXXXXXXXXXXXXXXXXXXXXXXXOOOOOOOOOOOOOOOOOOOOYYYOOOOOOOOOOOXXXXXXXXXXXXXXXXXOOXXXXXXXXXXXOOOOYX
XXXXXXXXXXXXXXXXXXXXXXXXXXXXXXXXXXXXXXXXXXXXXXXXXXXXXXOOOOOOOOOOOOOOOOOOOOYYYYYOOOYOOOOOOXXXXXXXXXXXXXXXOOXXXXXXXXXXOOOOOYX
XXXXXXXXXXXXXXXXXXXXXXXXXXXXXXXXXXXXXXXXXXXXXXXXXXXXXXOOOXXOOOOOOOOOOOOOOOOOOYYYYOYYXXXOOOOOXXXXXXXXXXXXOOXXXXXXXXXXOOOOYYX
XXXXXXXXXXXXXXXXXXXXXXXXXXXXXXXXXXXXXXXXXXXXXXXXXXXXXXXXOOXXOOOOOOOOOOOOOOOOOOOYYY3YYX3OOOOOXXXXXXXXXXXXOOXXXXXXXXOOOOOOYYX
XXXXXXXXXXXXXXXXXXXXXXXXXXXXXXXXXXXXXXXXXXXXXXXXXXXXXXXXXOOXXOOOOOOOOOOOOOYYOOOOYYY3Y3XXOOOOOOOOOOXXXXXXOOXXXXXXXXOOOOOOYYX
XXXXXXXXXXXXXXXXXXXXXXXXXXXXXXXXXXXXXXXXXXXXXXXXXXXXXXXXXXOOXXOOOOOOOOOOOOOYYYOO3YYY3YYX3XXOOOOOOOXXXXXOOOXXXXXXXOOOOOOYYXX
XXXXXXXXXXXXXXXXXXXXXXXXXXXXXXXXXXXXXXXXXXXXXXXXXXXXXXXXXXOOXXOOXXXXOOOOOOOOOOYY33Y3Y3Y3XXXXXXXXXOOOOOOOOXXXXXXXOOOOOOYYYXX
XXXXXXXXXXXXXXXXXXXXXXXXXXXXXXXXXXXXXXXXXXXXXXXXXXXXXXXXXXXOOXXOOOXXXXXXXXXOOO3YYY3YYY3YYXXXXXXXXXOOOOOOXXXXXXXOOOOOOYYYYXX
XXXXXXXXXXXXXXXXXXXXXXXXXXXXXXXXXXXXXXXXXXXXXXXXXXXXXXXXXXXXOOXXXOOXXXXXXXXXXYY3Y3Y3Y3Y3YYXXXXXXXXXXXXXXXXXXXXXOOOOOYYYYXXX
XXXXXXXXXXXXXXXXXXXXXXXXXXXXXXXXXXXXXXXXXXXXXXXXXXXXXXXXXXXXXOOOXXOOOXXXXXXXXXYY3YYY3YYY3YXXXXXXXXXXXXXXXXXXXXOOOOOOYYYXXXX
XXXXXXXXXXXXXXXXXXXXXXXXXXXXXXXXXXXXXXXXXXXXXXXXXXXXXXXXXXXXXXXOOXXXOO4OOXXXXXX3Y3Y3Y3YYYOOXXXXXXXXXXXXXXXXXXXOOOOOYYYXXXXX
XXXXXXXXXXXXXXXXXXXXXXXXXXXXXXXXXXXXXXXXXXXXXXXXXXXXXXXXXXXXXXXXOOOXXXXXOOOOOOOXYY3YYY3YYOOOXXXXXXXXXXXXXXXXOOOOOOYYYXXXXXX
XXXXXXXXXXXXXXXXXXXXXXXXXXXXXXXXXXXXXXXXXXXXXXXXXXXXXXXXXXXXXXXXXXOOOXXXXXXXXXXXX3Y3YYYOOOOOOOXXXXXXXXXXXXXOOOOOOYYYXXXXXXX
XXXXXXXXXXXXXXXXXXXXXXXXXXXXXXXXXXXXXXXXXXXXXXXXXXXXXXXXXXXXXXXXXXXOOOOXXXXXXXOO3XYY3YYOOOOOOOXXXXXXXXXXXOOOOOOOYYYXXXXXXXX
XXXXXXXXXXXXXXXXXXXXXXXXXXXXXXXXXXXXXXXXXXXXXXXXXXXXXXXXXXXXXXXXXXXXOOO4OOOOOOOOXXXYYOOOOOOOOOOXXXXXXOOOOOOOOOOYYYXXXXXXXXX
XXXXXXXXXXXXXXXXXXXXXXXXXXXXXXXXXXXXXXXXXXXXXXXXXXXXXXXXXXXXXXXXXXXXXXXXXXXXXXXXXXXXYOOOOOOOOOOOOOOOOOOOOOOOOYYYYXXXXXXXXXX
XXXXXXXXXXXXXXXXXXXXXXXXXXXXXXXXXXXXXXXXXXXXXXXXXXXXXXXXXXXXXXXXXXXXXXXXXXXXXXXXXXXXXYOOOOOOOOOOOOOOOOOOOOOOYYYYXXXXXXXXXXX
XXXXXXXXXXXXXXXXXXXXXXXXXXXXXXXXXXXXXXXXXXXXXXXXXXXXXXXXXXXXXXXXXXXXXXXXXXXXXXXXXXXXXYYYOOOOOOOOOOOOOOOOOYYYYYYXXXXXXXXXXXX
XXXXXXXXXXXXXXXXXXXXXXXXXXXXXXXXXXXXXXXXXXXXXXXXXXXXXXXXXXXXXXXXXXXXXXXXXXXXXXXXXXXXXXXYYYOOOOOOOOOOOOYYYYYYYXXXXXXXXXXXXXX
X1X123334XXXXXXXXXXXXXXXXXXXXXXXXXXXXXXXXXXXXXXXXXXXXXXXXXXXXXXXXXXXXXXXXXXXXXXXXXXXXXXXYYYYYOOOOOOOYYYYYYXXXXXXXXXXXXXXXXX
X1X12X3X4XXXXXXXXXXXXXXXXXXXXXXXXXXXXXXXXXXXXXXXXXXXXXXXXXXXXXXXXXXXXXXXXXXXXXXXXXXXXXXXXXXYYYYYYYYYYYXXXXXXXXXXXXXXXXXXXXX
X111223X4XXXXXXXXXXXXXXXXXXXXXXXXXXXXXXXXXXXXXXXXXXXXXXXXXXXXXXXXXXXXXXXXXXXXXXXXXXXXXXXXXXXYYYYYYYYXXXXXXXXXXXXXXXXXXXXXXX
XXXXXXXXXXXXXXXXXXXXXXXXXXXXXXXXXXXXXXXXXXXXXXXXXXXXXXXXXXXXXXXXXXXXXXXXXXXXXXXXXXXXXXXXXXXXXXXXXXXXXXXXXXXXXXXXXXXXXXXXXXX