PXXXXXXXXXXXXXXXXXXXXXXXXXXXXXXXXXXXXXXXXXXXXXXXXXXXXXXXXXXXXXXXXXXXXXXXXXXXXXXXXXXXXXXXXXXXXXXXXXXXXXXXXXXXXXXXXXXXXXXXXXX
PXXXXXXXXXXYYYYYYYYYXXXXXXXXXXXXXXXXXXXXXXXXXXXXXXXXXXXXXXXXXXXXXXXXXXXXXXXXXXXXXXXXXXXXXXXXXXXXXXXXXXXXXXXXXXXXXXXXXXXXXXX
PXXXXXXYYYYYYOOOOOOOOOOOOOXXXXXXXXXXXYYYYYYYYYYXXXXXXXXXXXXXXXXXXXXXXXXXXXXXXXXXXXXXXXXXXXXXXXXXXXXXXXXXXXXXXXXXXXXXXXXXXXX
PXXXXXYYYYYOOOOOOOOOOOOOOOOOOOOOOOOOOOOOOOYYYYYYXXXXXXXXXXXXXXXXXXXXXXXXXXXXXXXXXXXXXXXXXXXXXXXXXXXXXXXXXXXXXXXXXXXXXXXXXXX
PXXXYYYYOOOOOOOOOOOOOOOOOOOOOOOOOOOOOOOOOOOOOYYYYYXXXXXXXXXXXXXXXXXXXXXXXXXXXXXXXXXXXXXXXXXXXXXXXXXXXXXXXXXXXXXXXXXXXXXXXXX
PXXYYYYYOOOOOOOOOOOOOOOOOOOOOOOOOOOOOOOOOOOOOOOYYYYXXXXXXXXXXXXXXXXXXXXXXXXXXXXXXXXXXXXXXXXXXXXXXXXXXXXXXXXXXXXXXXXXXXXXXXX
PXXYYYOOOOOOOOOOOOOOOOOOOOOOOOOOOOOOOOOOOOOOOOOOOOYYXXXXXXXXXXXXXXXXXXXXXXXXXXXXXXXXXXXXXXXXXXXXXXXXXXXXXXXXXXXXXXXXXXXXXXX
PXXYYOOOOOOOOOOOOOOOOOOOOOXXXXXXXXOOOOOOOOOOOOOOOOOOOXXXXXXXXXXXXXXXXXXXXXXXXXXXXXXXXXXXXXXXXXXXXXXXXXXXXXXXXXXXXXXXXXXXXXX
PXXYOOOOOOOOOOOOOOOOOOOOXXXXXXXXXXXXXOOOOOOOOOOOOOOOOOOXXXXXXXXXXXXXXXXXXXXXXXXXXXXXXXXXXXXXXXXXXXXXXXXXXXXXXXXXXXXXXXXXXXX
XXXYOOOOOOOOXXXXXXOOOOXXXXXXXXXXXXXXXXXXOOOOOOOOOOOYYOOOXXXXXXXXXXXXXXXXXXXXXXXXOOOOOXXXXXXXXXXXXXXXXXXXXXXXXXXXXXXXXXXXXXX
XXXYOOOOOOOXXXXXXXOOXXXXXXXXXXXXXXXXXXXXXXOOOOOOOOOYYXOOOXXXXXXXXXXXXXXXXXXXXXXOOOOXOOXXXXXXXXXXXXXXXXXXXXXXXXXXXXXXXXXXXXX
XXXOOOOOOOXXXXXXXOOXXXXXXXXXXXXXXXXXXXXXXXXXOOOOOOOYYXXXOOXXXXXXXXXXXXXXXXXXXXOOXXXXXOOXXXXXXXXXXXXXXXXXXXXXXXXXXXXXXXXXXXX
XXXOOOOOOOXXXXXXOOXXXXXXXXXXXXXXXXXXXXXXXXXXXOOOOOOOYXXXOOXXXXXXXXXXXXXXXXXXXXOOXXXXXXOXXXXXXXXXXXXXXXXXXXXXXXXXXXXXXXXXXXX
XXXOOOOOOOXXXXXOOXXXXXXXXXXXXXXXXXXXXXXXXXXXXXOOOOOOYXXXXOOOXXXXXXXXXXXXXXXXXXOOXXXXXXOXXXXXXXXXXXXXXXXXXXXXXXXXXXXXXXXXXXX
XXXOOOOOOXXXXXOOXXXXXXXXXXXXXXXXXXXXXXXXXXXXXXOOOOOOXXXXXXOOOXXXXXXXXXXXXXXXXOOXXXXXXOOXXXXXXXXXXXXXXXXXXXXXXXXXXXXXXXXXXXX
XXXOOOOOOXXXXOOXXXXXXXXXVGVVVVVXXXXXXXXXXXXXXXOOOOOOXXXXXXXXOOOXXXXXXXXO9OOOOOXXXXXXOOXXXXXXXXXXXXXXXXXXXXXXXXXXXXXXXXXXXXX
XXXOOOOOOXXXOOXXXXXXXXVVXGXXXXXVVVVVVXXXXXXXXXOOOOOOXXXXXXXXXOOXXXXXXXOO9OOOOXXXXXXXOOXXXXXXXXXXXXXXXXXXXXXXXXXXXXXXXXXXXXX
XXXOOOOOOXXOOOXXXXXXVVXXXGXXXXXXXXXXXVVVVVVXXXOOOOOOXXXXXXXXXXOOXXXXXXOOXXXXXXXXXXXOOXXXXXXXXXXXXXXXXXXXXXXXXXXXXXXXXXXXXXX
XXXOOOOOOXXOOOXXXVVVXXXXXGXXXXXXXXXXXXXXXXXVVVVVVOOOXXXXXXXXXXOOXXXXXXOXXXXXXXXXXXXOXXXXXXXXXXXXXXXXXXXXXXXXXXXXXXXXXXXXXXX
XXXOOOOOOXXOOOX55V5V5555555555555555555555555555555555555555XXXOOXXXXOOXXXXXXXXXXXXOOOXXXXXXXXXXXXXXXXXXXXXXXXXXXXXXXXXXXXX
XXXOOOOOOXXOOOX555V55555555555555555555555555555555555555555XXXXOOXXOOXXXXXXXXXXXXXXOOOXXXXXXXXXXXXXXXXXXXXXXXXXXXXXXXXXXXX
XXXOOOOOOXXOOOXXXVVVXXXXGXVVVXXXXXXXXXXXXXXXXXOOOOOOXXXXVXXXXXXXXOOOOXXXXXXXXXXXXXXXYYOYYXXXXXXXXXXXXXXXXXXXXXXXXXXXXXXXXXX
XXXOOOOOOXXOOOXXXXXXXXXXGGVWVXXXXXXXXXXXXXXXXXOOOOOOXXXXVXXXXXXXXXXXXXXXXXXXXXXXXXYYYYOOYXXXXXXXXYYYYXXXXXXXXXXXXXXXXXXXXXX
XXXOOOOOOXXOOOXXXXXXXXXXGXVVVXXXXXXXXXXXXXXXXXOOOOOOXXXXVXXXXXXXXXXXXXXXXXXXXXXXYYYOOOOOYYXXXXXXYYOOYYYXXXXXXXXXXXXXXXXXXXX
XXXOOOOOOXXOOOXXXXXXXXXXGGGXXXXXXXXXXXXXXXXXXXOOOOOOXXXXVXXXXXXXXXXXXXXXXXXXXXXYYOOOOOOOOYYXXXXXOOOOOYYYXXXXXXXXXXXXXXXXXXX
XXXOOOOOOXXOOOXXXXXXXXXXGXGXXXXXXXXXXXXXXXXXXXOOOOOOXXXXVXXXXXXXXXXXXXXXXXXXXXYYOOOOOOOOOOOOOOOOOOOOOOYYYYXXXXXXXXXXXXXXXXX
XXXOOOOOOXXOOOXXXXXXXXXXGGGXXXXXXXXXXXXXXXXXXXOOOOOOXXXXVXXXXXXXXXXXXXXXXXXXXXYOOOOOOOOOOOOOOOOOOOOOOOOOYYYXXXXXXXXXXXXXXXX
XXXOOOOOOXXOOOXXXXXXXXXXGXGXXXXXXXXXXXXXXXXXXXOOOOOOXXXVXVXXXXXXXXXXXXXXXXXXXXOOOOOOOOOOOOOOOOOOOOOOOOOOOOYYYXXXXXXXXXXXXXX
XXXOSOSOSXXOSOXXXXXXXXXXGGGXXXXXXXXXXXXXXXXXXXOOOOOOXXVXXXVXXXXXXXXXXXXXXXXXXXOOOOOOOOOOOOOOOOOOOOOOOOOOOOOOYYYXXXXXXXXXXXX
XXXSOSOSOXXSOSXXXXXXXXXXGXGXXXXXXXXXXXXXXXXXXXOOOOOOXXZZZZZXXXXXXXXXXXXXXXXXXXOOOOOOOOOOOOOOOOOOOOOOOOOOOOOOOYYXXXXXXXXXXXX
XXXFFFFFFXXFFFXXXXXXXXXXGGGXXXXXXXXXXXXXXXXXXXOOOOOOXXXXXXXXXXXXXXXXXXXXXXXXXOOOOOOOOOOOOOOOOOOOOOOOOOOOOOOOOOYXXXXXXXXXXXX
XXXOOOOOOXXOOOXXXXXXXXXXGXGXXXXXXXXXXXXXXXXXXXOOOOOOXXXXXXXXXGGXXXXXXXXXXXXXXOOOOOOXXXXXYOOOOOOOOYYXXXXXOOOOOOYXXXXXXXXXXXX
XXXOOOOOOXXOOOXXXXXXXXXXGGGXXXXXXXXXXXXXXXXXXXOOOOOOXXXXXXXXGGGGXXXXXXXXXXXXOOOOOOXXXXXXYYYOOOOOYYXXXXXXXXOOOOOXXXXXXXXXXXX
XXXOOOOOOXXOOOXXXXXXXXXXGXGXXXXXXXXXXXXXXXXXXXOOOOOOXXXXXXXGGGXGGXXXXXXXXXXXOOOOOXXXXXXXXYYYYOOOOOOXXXXXXXXXOOOOXXXXXXXXXXX
XXXOOOOOOXXOOOXXXXXXXXXXGGGXXXXXXXXXXXXXXXXXXXOOOOOOXXXXXXVVVXXXGGXXXXXXXXXOOOOOXXXXXXXXXXXXYYYYYOOOXXXXXXXXXOOOOXXXXXXXXXX
XXXOOOOOOXXOOOXXXXXXXXXXGXGXXXXXXXXXXXXXXXXXXXOOOOOOXXXXXGVWVXXXXGGXXXXXXXOOOOOOXXXXXXXXXXXXXXXXXXOOXXXXXXXXXXOOOOXXXXXXXXX
XXXOOOOOOXXOOOXXXXXXXXXXGGGXXXXXXXXXXXXXXXXXXXOOOOOOOXXXGGVVVGGXXXTTXXXXXXOOOOOOXXXXXXXXXXXXXXXXXXXOOXXXXXXXXXXOOOOXXXXXXXX
XXXOOOOOOXXOOOXXXXXXXXXXGXGXXXXXXXXXXXXXXXXXXYOOOOOOOOXXGGGGGGGXXZTTXXXXXOOOOOOXXXXXXXXXXXXXXXXXXXXOOXXXXXXXXXXXOOOOXXXXXXX
XXXOOOOOOXXOOOXXXXXXXXXGGGGGXXXXXXXXXXXXXXXXXYOOOOOOOOOOGTTTTTGXXTTXXXXXOOOOOOOXXXXXXXXXXXXXXXXXXXXXOOXXXXXXXXXXOOOOXXXXXXX
XXXOOOOOOXXOOOXXXXXXXXGXGXGXGXXXXXXXXXXGXXXXXYOOOOOOOOOOTVGVGVTXXXXXXXXOOOOOOOYXXXXXXXXXXXXXXXXXXXXXXOOXXXXXXXXXOOOOOXXXXXX
XXXOOOOOOXXXOOXXXXXXXGGGGGGGGGXXXXXXXXGGGXXXXYOOYOOOOOOOOTTTTTZZZZZZZXOOOOOOOYYXXXXXXXXXXXXXXXXXXXXXXXOXXXXXXXXXXOOOOXXXXXX
XXXOOOOOOXXXOOOXXXXXXXXXXXXXXXXXXXXXXGGGGGXXXYOOOOOOOOOOOOOOOZZZZZZZZZOOOOOOYYXXXXXXXXXXXXXXXXXXXXXXXXOOXXXXXXXXXXOOOXXXXXX
XXXOOOOOOXXXXOOOXXXXXXXXXXXXXXXXXXXXXXGGGGGXXOOOOOYYYYOOOOOOOOZZZZZZZZZOOOOYYYXXXXXXXXXXXXXXXXXXXXXXXXXOOXXXXXXXXXOOOOXXXXX
XXXOOOOOOXXXXOOOXXXXXXXXXXXXXXXXGGGXXXVGGGGGXOOOOYYYYYYYOOOOOOZZZZZZZZ6666YYYYXXXXXXXXXXXXXXXXXXXXXXXXXXOOXXXXXXXXOOOOXXXXX
XXXOOOOOOXXXXXOOXXXXXXXXXXXXXXXGWGGXXVXXGGGGGZZZYYYYYYYYZZOOOOOZZZZ66666YYYYXXXXXXXXXXXXXXXXXXXXXXXXXXXXOOXXXXXXXXXOOOOXXXX
XXYOOOOOOXXXXXOOOXXXXXXXXXXXXXGWWGGXVXXXXGGGGZZZZZZZZZZZZZZOOOOO6666666YYXXXXXXXXXXXXXXXXXXXXXXXXXXXXXXXXOOXXXXXXXXXOOOXXXX
XXYOOOOOOXXXXXXOOOXXXXXXXXXXXXGGGGGVXXXXXXGGZZZZZZZZZZZZZZZZZZZZZZZZZZZZXGGGXXXXXXXXXXXXXXXXXXXXXXXXXXXXXXOOXXXXXXXXOOOXXXX
XXYOOOOOOXXXXXXXOOOXXXXXXXXXXXGGGGGGGGGGGGGOZZZZZZZZZZZZZZZZZZZZZZZZZZZXXGWGVVXXXXXXXXXXXXXXYXXXXXXXXXXXXXOOXXXXXXXXXOOOXXX
XYYOOOOOOOXXXXXXXOOOXXXXXXXXXXXTTXXXXTTXTTOOXXOZZZZZZZZZZZZZZZZZZZZZZZGXGGGGGGGXXXXXXXXXXXXYXXXXXXXXXXXXXXOOXXXXXXXXXOOOXXX
XYYYOOOOOOXXXXXXXXOOOOOXXXXXXXXXXXXXXXXXOOOXXXOOXXZZZZZZZZZZZZZZZZZZZZZGGTTTTTGXXXXXXXYYYYYXXXXXXXXXXXXXXXOOXXXXXXXXX28OXXX
XYYYOOOOOOXXXXXXXXXOOOOOOOXXXXXXXXXXXXOOOOXXXXOOOXXXZZZXXXXXXXZZZZZZZZZGTVGVGVTXXXXXXXYXXXYXXXXXXXXXXXXXXXXOXXXXXXNNNNNNOXX
XYYYOOOOOOOXXXXXXXXXOOOOOOOOOOOOOOOOOOOOXXXXXXXOOOXXXXXXXXXXXXXXXXZZZZGXXTTTTTXXXXXXXXYXYXYXXXXXXXXXXXXXXXXOXXXXXXNNLNNWNXX
XXYYYOOOOOOOXXXXXXXXXOOOOOOOOOOOOOOOOOOOOOONNNNNNNN28XXXXXXXXXXXXXXXXXXXXXXXXXXXXXXXXXYXXXYXXXXXXXXXXXXXXXX1XXXXXXNLLLNWWNX
XXYYYOOOOOOOOOOOOOOOOOOOOOOOOOOOOOOOOOOOOOOOVVOOOOOLLLXXXXXXXXXXXXXXXXXXXXXXXXXXXXXXXXYYYYYXXXXXXXXXXXXXXXXOXXXXXXNNLNNNNNX
XXXYYYOOOOOOOOOOOOOOOOOOOOOOOOOOOOOOOOOOOOOLLLLLLLLLLWLXXXXXXXXXXXXXXXXXXXXXXXXXXXXXXXXXYXXXXXXXXXXXXXXXXXXOXXXXXXNNNNNNNNX
XXXXYYOOOOOOOOOOOOOOOOOOOOOOOOOOOOOOOOOOOOOLLLLLLLLLLWWLXXXXXXXXXXXXXXXXXXXXXXXXXXXXXXXXYXXXXXXXXXXXXXXXXXXOXXXXXXXTTOOTTXX
XXXXYYYOOOOOOOOOOOOOOOOOOOOOOOOOOOOOOOOOOOOLLLLLLLLLLLLLOOOOXXXXXXXXXXXXXXXXXXXXXXXXXXXXXXXXXXXXXXXXXXXXXXXOXXXXXXXXXL77XXX
XXXXXYYYOOOOOOOOOOOOOOOOOOOOOOOOOOOOOOOOOOOLLLLLLLLLLLLLOOOOOOXXXXXXXYYYYYYYXXXXXXXXXXXXXXXXXXXXXXXXXXXXXXOOXXXXXXXXX7L7YXX
XXXXXXYYYOOOOOOOOOOOOOOOOOOOOOOOOOOOOOOOOOOOTTOTTOOOOTTOOOOOOOOOXYYYYYYOOOOOXXXXXXXXXXXXXXXXXXXXXXXXXXXXXXOOXXXXXXXXX77LYYX
XXXXXXXYYYYOOOOOOOOOOOOOOOOOOOOOOOOOOOOOOOOOOOOOOOOOOOOOOOOOOOOOOOYYOOOOOOOOOXXXXXXXXXXXXXXXXXXXXXXXXXXXXOOOXXXXXXXXXOOOOYX
XXXXXXXXXXXXXXXXXXXXXXXXXXXXXXXXXXXXXXXXXXXXXXXXOOOOOOOOOOOOOOOOOOOOOOOOOOOOOOOXXXXXXXXXXXXXXXXXXXXXXXXXOOOXXXXXXXXXXOOOOYX
XXXXXXXXXXXXXXXXXXXXXXXXXXXXXXXXXXXXXXXXXXXXXXXXXXXXXOOOOOOOOOOOOOOOOOOOOYYYOOOOOOOOOOOXXXXXXXXXXXXXXXXXOOXXXXXXXXXXXOOOOYX
XXXXXXXXXXXXXXXXXXXXXXXXXXXXXXXXXXXXXXXXXXXXXXXXXXXXXXOOOOOOOOOOOOOOOOOOOOYYYYYOOOYOOOOOOXXXXXXXXXXXXXXXOOXXXXXXXXXXOOOOOYX
XXXXXXXXXXXXXXXXXXXXXXXXXXXXXXXXXXXXXXXXXXXXXXXXXXXXXXOOOXXOOOOOOOOOOOOOOOOOOYYYYOYYXXXOOOOOXXXXXXXXXXXXOOXXXXXXXXXXOOOOYYX
XXXXXXXXXXXXXXXXXXXXXXXXXXXXXXXXXXXXXXXXXXXXXXXXXXXXXXXXOOXXOOOOOOOOOOOOOOOOOOOYYY3YYX3OOOOOXXXXXXXXXXXXOOXXXXXXXXOOOOOOYYX
XXXXXXXXXXXXXXXXXXXXXXXXXXXXXXXXXXXXXXXXXXXXXXXXXXXXXXXXXOOXXOOOOOOOOOOOOOYYOOOOYYY3Y3XXOOOOOOOOOOXXXXXXOOXXXXXXXXOOOOOOYYX
XXXXXXXXXXXXXXXXXXXXXXXXXXXXXXXXXXXXXXXXXXXXXXXXXXXXXXXXXXOOXXOOOOOOOOOOOOOYYYOO3YYY3YYX3XXOOOOOOOXXXXXOOOXXXXXXXOOOOOOYYXX
XXXXXXXXXXXXXXXXXXXXXXLXXXXXTTTTTTTTTTTXXXXXXXXXXXXXXXXXXXOOXXOOXXXXOOOOOOOOOOYY33Y3Y3Y3XXXXXXXXXOOOOOOOOXXXXXXXOOOOOOYYYXX
XXXXXXXXXXXXXXXXXXXXXTLTXXXXXXXXXTXXXXXXXXXXXXXXXXXXXXXXXXXOOXXOOOXXXXXXXXXOOO3YYY3YYY3YYXXXXXXXXXOOOOOOXXXXXXXOOOOOOYYYYXX
XXXXXXXXXXXXXXXXXXXXXXTLLLLLLLLLLLLLXXXXXXXXXXXXXXXXXXXXXXXXOOXXXOOXXXXXXXXXXYY3Y3Y3Y3Y3YYXXXXXXXXXXXXXXXXXXXXXOOOOOYYYYXXX
XXXXXXXXXXXXXXXXXXXXXTXTXLLLLLLLLLWWLXXXXXXXXXXXXXXXXXXXXXXXXOOOXXOOOXXXXXXXXXYY3YYY3YYY3YXXXXXXXXXXXXXXXXXXXXOOOOOOYYYXXXX
XXXXXXXXXXXXXXXXXXXXXXXXXXXXXLLLLLLWLXXXXXXXXXXXXXXXXXXXXXXXXXXOOXXXOO4OOXXXXXX3Y3Y3Y3YYYOOXXXXXXXXXXXXXXXXXXXOOOOOYYYXXXXX
XXXXXXXXXXXXXXXXXXXXXXXXXXXXXXXLLLLLLXXXXXXXXXXXXXXXXXXXXXXXXXXXOOOXXXXXOOOOOOOXYY3YYY3YYOOOXXXXXXXXXXXXXXXXOOOOOOYYYXXXXXX
XXXXXXXXXXXXXXXXXXXXXXXXXXXXXXXXLLLLXXXXXXXXXXXXXXXXXXXXXXXXXXXXXXOOOXXXXXXXXXXXX3Y3YYYOOOOOOOXXXXXXXXXXXXXOOOOOOYYYXXXXXXX
XXXXXXXXXXXXXXXXXXXXXXXXXXXXXXXXVXVXXXXXXXXXXXXXXXXXXXXXXXXXXXXXXXXOOOOXXXXXXXOO3XYY3YYOOOOOOOXXXXXXXXXXXOOOOOOOYYYXXXXXXXX
XXXXXXXXXXXXXXXXXXXXXXXXXXXXXXXVVVVVXXXXXXXXXXXXXXXXXXXXXXXXXXXXXXXXOOO4OOOOOOOOXXXYYOOOOOOOOOOXXXXXXOOOOOOOOOOYYYXXXXXXXXX
XXXXXXXXXXXXXXXXXXXXXXXXXXXXXXXXXXXXXXXXXXXXXXXXXXXXXXXXXXXXXXXXXXXXXXXXXXXXXXXXXXXXYOOOOOOOOOOOOOOOOOOOOOOOOYYYYXXXXXXXXXX
XXXXXXXXXXXXXXXXXXXXXXXXXXXXXXXXXXXXXXXXXXXXXXXXXXXXXXXXXXXXXXXXXXXXXXXXXXXXXXXXXXXXXYOOOOOOOOOOOOOOOOOOOOOOYYYYXXXXXXXXXXX
XXXXXXXXXXXXXXXXXXXXXXXXXXXXXXXXXXXXXXXXXXXXXXXXXXXXXXXXXXXXXXXXXXXXXXXXXXXXXXXXXXXXXYYYOOOOOOOOOOOOOOOOOYYYYYYXXXXXXXXXXXX
XXXXXXXXXXXXXXXXXXXXXXXXXXXXXXXXXXXXXXXXXXXXXXXXXXXXXXXXXXXXXXXXXXXXXXXXXXXXXXXXXXXXXXXYYYOOOOOOOOOOOOYYYYYYYXXXXXXXXXXXXXX
X1X123334XXXXXXXXXXXXXXXXXXXXXXXXXXXXXXXXXXXXXXXXXXXXXXXXXXXXXXXXXXXXXXXXXXXXXXXXXXXXXXXYYYYYOOOOOOOYYYYYYXXXXXXXXXXXXXXXXX
X1X12X3X4XXXXXXXXXXXXXXXXXXXXXXXXXXXXXXXXXXXXXXXXXXXXXXXXXXXXXXXXXXXXXXXXXXXXXXXXXXXXXXXXXXYYYYYYYYYYYXXXXXXXXXXXXXXXXXXXXX
X111223X4XXXXXXXXXXXXXXXXXXXXXXXXXXXXXXXXXXXXXXXXXXXXXXXXXXXXXXXXXXXXXXXXXXXXXXXXXXXXXXXXXXXYYYYYYYYXXXXXXXXXXXXXXXXXXXXXXX
XXXXXXXXXXXXXXXXXXXXXXXXXXXXXXXXXXXXXXXXXXXXXXXXXXXXXXXXXXXXXXXXXXXXXXXXXXXXXXXXXXXXXXXXXXXXXXXXXXXXXXXXXXXXXXXXXXXXXXXXXXX