PXXXXXXXXXXXXXXXXXXXXXXXXXXXXXXXXXXXXXXXXYYYYYZZZWWWWWWWWWWWWWWWWWWWZZZZZZZZZZZYYYYYYVVVVVVVV
PXXXOOOOOOOOOOOOOFFSOSOSOOOOOOOOXXXXXXXYYYYYYYYYZZZZZZZZWWWWWWWWWWZZZOOOOOOZZZZZYYYO5VVVVVVVV
PXXOOOOWWOOOOOOOOFFSOSOSOOOOOOOOOOOOOOOOOOOOYYYYYYYYYYYZZZZZWWWWWZZOOOOOOOOOOZZZZOOOVVVVVVVVV
PXOOOOOOWOOOOOOOOFFSOSOSOOOOWWWOOOOOOOOOOOOOOOOOOYYYYYYYYY6ZWWWWZZOOOOOOOOOOOOOOOOOOVVVO9OVVV
PXOOOOOOOOOOOOOOOFFSOSOSOOOOOOWOOOOOOOOOOOOOOOOOOOOOYYYYYOZZWWWZZOOOZOOOOOOOOOOOOOOVVVOTTTOVV
PXOOOOOOOOOOOOOOOFFSOSOSOOOOOOOOOOOOOOOOOOOOOOOZOOOOOOOOOOZWWWZZOOOOZOOOOOOOOOOOOOOVVOTLLLTOV
PXOOOOOZZZZZZZYYYYYYYYYYYYYYYOOOOOOOOOOOOOZOOOOOOOOOOOOOOZWWWWZZOOOOOOOOZZZZOOOOOOOVVOTLLLTOV
PXOOOOZZZZZZZZZZZZOOOOOOOOYYYYYYYYXXXXXOOOOOOOOOOOOOOOOOZZWWWWZZOOOOOOOZZYYZZZZOOOOVVOTLLTOVV
PXXOOOOOOOZZZZOOOOOOOOOOOOOOOOOOOOXXXXXXXXXXOOOOOOOOOOOOZWWWWZZOOOOOOOYYYYYYZZZZOOOVVOTLTTOVV
PXXXOOOOOOOOOOOOOOOOZZZOOOOOOOOOOOOOXXXXVVVXXXXOOOOOOOOOOZWWWZZOOOOOOOYYWWWYYYZOOOOVOTTLTOOVV
PXXXYYOOOOOOOOOOOOZZWWWWWWOOOXXOOOOOOXXVVVVXXXXXOOOOOOOOOZZWWZZOOOOOOOYYWWYYYYOOOOOVOTTLTOOVV
PXXYYYYZZZZZZZZZZZWWWWWW2OZZXXXXXOOOOOXVVVXXXXXXXOOOOOOOOOZZZZOOOZOOOOYWWYYYOOOOOOVVOTTTOOVVV
PXYYZZZZOOOOOOOOOOOZZWW2ZZZXXXXXXXOOOOXXXXXOOOXXXXOOOOOOOOOZZOOOOOOOOYYWWYYOOOOOOVVVVOTOOOVVV
PYZZOOOOOOOOOOOOOOOOXXXXXXXXXXXXXXXOOOXXXOOOOOOXXXOOOOOZOOOOOOOOOOOOOYYYYYOOOOOOOVVVVOOOOVVVV
PYOOOOOOOOZZWWWWZOOOX1X123334XX3XXXOOOXXOOOOOOOOXXOOOOOOZOOOOOOOOOOOOXXXOOOOOOOOVVVVOOOOOOOVV
YXOOOOWWOOOWWW1WWWOOX1X12X3X4XXXOOXOOOXXOOOOOOOOOXXOOOOOOZZZYYYOOOOOXXXOOOOOOOOVVVVOOOVVOOOOV
XOOOOOWWOOOWWWOOWWOOX111223X4XXXXOOOOOXXOOOOLOOOOXXOOOOOOOZZZYOOOOOXXXOOOOOOVVVVVVOOOVVVZOOOV
XOOOOWWWZOOWWWWOOWOOXXXXXXXXXXXXXOOOOOXXOOOL7LOOOXXXOOOOOOOOOOOOOOXXXOOOOOVVVVVVVOOOVVVZZOOOV
XOOOOWWWZOOZZWWOOOOOOOOOXXXXXXXXXOOOOOXXOOOOLOOOOXXXXOOOOOOOOOOOOXXXXOOOOVVVVVVVOOOVVVVZOOOOV
XOOOOZWWWOOOZZZOOOOOOOOOXXXXXXXOOOOOOXXXXOOOLOOOXXXXXXXOOOOOOOOOXXXXXOOOOOVVVOOOOOVVVVZZOOOOV
XOOOOOWWWOOOOOOOOOOOOOOOOOOOOOOOOOOOXXXXXOOOLOOOXXVVVVXXXXOOOOXXXVVVXXOOOOOOOOOOOVVVVZZOOOOVV
XOOOOOZWWZOOOOOOZZZZZZOOOOOOOOOOOOOXXXXXXOOOLOOOXXVVVVVVVXXXXXXXVVVVVXXOOOOOOOOVVVVVZZOOOOOVV
XOOOOOOZWWZZOOOZZZZZZZZZOOOOOOOOXXXXXZZZOOOOLOOOOXVVVVVVVVXXXX4XVVVVVVXXXXXXXXXXVZZZOOOOOOVVV
XOOOOOOOZZWZZZZZZYYYYYZZZZZXXXXXXXZZZZOOOOOOLTOOOXXXXVVVVXXXXOOXXXVVVVXXXXXXXXXZZZOOOOOOOZZVV
XXOOOOOOOOOOOOOOYYYYYYYYYYYYYYYYZZZOOOOOOOOOTLOOOOXXXXXXXXXOOOOOOXXXXXXOOOOOOZZZOOOOOOOOXXXZZ
XXOOOOOOOOOOOOOOOOOOOOOOOOYYYYYZOOOOOOOOOOOTTLOOOOOOOOOXXOOOOOOOOOOXXOOOOOOOOOOOOOOOOOOXXXXXX
XXXOOOOOOOOOOOOOOOOOOOOOOOOOOOOOOOOOOOOOOOOTLTVOOOOOOOOOOOOOOOOOOOOOOOOOOOOOOOOOOOOOOYXXXOXOX
XXXXOOOOOOWOOOOOOOOOOOOOOOOOOOOOOOOOOOOOOTTLLTVOOOOOOOOOOOOOOXXOOOOOOOOOOYYOOOOOOYYYYXXXXOOXX
XXXXXXOOOOOOOOOOOOOOOOOOOXXXXXOOOOOOOOVVTTLLTV8OOVVVVOOOOOOXXXXXOOOOOOOYYYYYYYYYYYXXXXXXXOXOX
XXXXXXXXXXXXXXXXXXXXXXXXXXXXXXVVVVVVVVVTTLLLLTTVVVVVVVVVVVVXXXXXXXXXXXXXXXYYYYYYXXXXXXXXXXXXX