TTTTTTTTTTTTTTTTTTTTTTTTTTTTTTTTTTTTTTTTTTTTTTTTTTTTTTTTTTTTTTTTT
TTTTTTTTTTTTTTTTTTTTTTTTTTTTTTTT9TTTTTTTTTTTTTTTTTTTTTTTTTTTTTTTT
TTTTTTTTTTTTTTTTTTTTTTTTTTTTTTTO9OTTTTTTTTTTTTTTTTTTTTTTTTTTTTTTT
TTTTTTTTTTTTTTTTTTTTTTTTTTTTTTTO9OTTTTTTTTTTTTTTTTTTTTTTTTTTTTTTT
TTTTTTTTTTTTTTTTTTTTTTTTTTTTTTTO9OTTTTTTTTTTTTTTTTTTTTTTTTTTTTTTT
TTTTTTTTTTTTTTTTTTTTTTTTTTTTTTTO9OTTTTTTTTTTTTTTTTTTTTTTTTTTTTTTT
TTTTTTTTTTTTTTTTTTTTTTTTTTTTTTOO9OOTTTTTTTTTTTTTTTTTTTTTTTTTTTTTT
TTTTTTTTTTTTTTTTTTTTTTTTTTTTTTOO9OOTTTTTTTTTTTTTTTTTTTTTTTTTTTTTT
TTTTTTTTTTTTTTTTTTTTTTTTTTTTTTOO9OOTTTTTTTTTTTTTTTTTTTTTTTTTTTTTT
TTTTTTTTTTTTTTTTTTTTTTTTTTTTTOOO9OOOTTTTTTTTTTTTTTTTTTTTTTTTTTTTT
TTTTTTTTTTTTTTTTTTTTTTTTTTTTTOOONOOOTTTTTTTTTTTTTTTTTTTTTTTTTTTTT
TTTTTTTTTTTTTTTTTTTTTTTTTTTTTOOONOOOTTTTTTTTTTTTTTTTTTTTTTTTTTTTT
TTTTTTTTTTTTTTTTTTTTTTTTTTTTOOOONOOOOTTTTTTTTTTTTTTTTTTTTTTTTTTTT
TTTTTTTTTTTTTTTTTTTTTTTTTTTTOOONNNOOOTTTTTTTTTTTTTTTTTTTTTTTTTTTT
TTTTTTTTTTTTTTTTTTTTTTTTTTTTOOONNNOOOTTTTTTTTTTTTTTTTTTTTTTTTTTTT
TTTTTTTTTTTTTTTTTTTTTTTTTTTOOOONNNOOOOTTTTTTTTTTTTTTTTTTTTTTTTTTT
TTTTTTTTTTTTTTTTTTTTTTTTTTTOOONNNNNOOOTTTTTTTTTTTTTTTTTTTTTTTTTTT
TTTTTTTTTTTTTTTTTTTTTTTTTTTOOONNNNNOOOTTTTTTTTTTTTTTTTTTTTTTTTTTT
TTTTTTTTTTTTTTTTTTTTTTTTTTOOOONNNNNOOOOTTTTTTTTTTTTTTTTTTTTTTTTTT
TTTTTTTTTTTTTTTTTTTTTTTTTTOOONNNNNNNOOOTTTTTTTTTTTTTTTTTTTTTTTTTT
TTTTTTTTTTTTTTTTTTTTTTTTTTOOONNNNNNNOOOTTTTTTTTTTTTTTTTTTTTTTTTTT
TT5OOOOOOOOOOOOOOOOOOOOOOOOOOOSOFOSOOOOOOOOOOOOOOOOOOOOOOOOOOO1TT
TOO55OOOOOOOOOOOOOOOOOOOOOOOOOSOFOSOOOOOOOOOOOOOOOOOOOOOOOOO11OOT
TOOOO55OOOOOOOOOOOOOOOOOOOOOOOSOFOSOOOOOOOOOOOOOOOOOOOOOOO11OOOOT
TTOOOOOGGGGGGGGGGGGGGGGGOOOOTTTTTTTTTOOOOWWWWWWWWWWWWWWWWWOOOOOTT
TTTTOOOOOGGGGGGGGGGGGGGGOOOTTTTTTTTTTTOOOWWWWWWWWWWWWWWWOOOOOTTTT
TTTTTOOOOOGGGGGGGGGGGGGGOOOTTTTTTTTTTTOOOWWWWWWWWWWWWWWOOOOOTTTTT
TTTTTTOOOOOGGGGGGGGGGGGOOOOTTTTTTTTTTTOOOOWWWWWWWWWWWWOOOOOTTTTTT
TTTTTTTTOOOOGGGGGGGGGGGOOOTTTTTTTTTTTTTOOOWWWWWWWWWWWOOOOTTTTTTTT
TTTTTTTTTOOOOOGGGGGGGGGOOOTTTTTTTTTTTTTOOOWWWWWWWWWOOOOOTTTTTTTTT
TTTTTTTTTTOOOOOGGGGGGGOOOOTTTTTTTTTTTTTOOOOWWWWWWWOOOOOTTTTTTTTTT
TTTTTTTTTTTOOOOOGGGGGGOOOTTTTTTTTTTTTTTTOOOWWWWWWOOOOOTTTTTTTTTTT
TTTTTTTTTTTTTOOOOGGGGGOOOTTFFFTFFTTFTFTTOOOWWWWWOOOOTTTTTTTTTTTTT
TTTTTTTTTTTTTTOOOOOGGGOOOTTFTTTFTFTFTFTTOOOWWWOOOOOTTTTTTTTTTTTTT
TTTTTTTTTTTTTTTOOOOOGOOOOTTFFTTFFTTFFFTTOOOOWOOOOOTTTTTTTTTTTTTTT
TTTTTTTTTTTTTTTTOOOOOOOOTTTFTTTFTFTTTFTTTOOOOOOOOTTTTTTTTTTTTTTTT
TTTTTTTTTTTTTTTTTTOOOOOOTTTFFFTFFTTTTFTTTOOOOOOTTTTTTTTTTTTTTTTTT
TTTTTTTTTTTTTTTTTTTOOOOOTTTTTTTTTTTTTTTTTOOOOOTTTTTTTTTTTTTTTTTTT
TTTTTTTTTTTTTTTTTTTTOOOOOTTTTTTTTTTTTTTTOOOOOTTTTTTTTTTTTTTTTTTTT
TTTTTTTTTTTTTTTTTTTTOOOOOOTTTTTTTTTTTTTOOOOOOTTTTTTTTTTTTTTTTTTTT
TTTTTTTTTTTTTTTTTTTOOOOOOOOTTTTTTTTTTTOOOOOOOOTTTTTTTTTTTTTTTTTTT
TTTTTTTTTTTTTTTTTTTOOOXXOOOOTTTTTTTTTOOOOLLOOOTTTTTTTTTTTTTTTTTTT
TTTTTTTTTTTTTTTTTTTOOOXXXOOOOOTTTTTOOOOOLLLOOOTTTTTTTTTTTTTTTTTTT
TTTTTTTTTTTTTTTTTTOOOOXXXXXOOOOTTTOOOOOLLLLOOOOTTTTTTTTTTTTTTTTTT
TTTTTTTTTTTTTTTTTTOOOXXXXXXXOOOOTOOOOLLLLLLLOOOTTTTTTTTTTTTTTTTTT
TTTTTTTTTTTTTTTTTTOOOXXXXXXXXOOOOOOOLLLLLLLLOOOTTTTTTTTTTTTTTTTTT
TTTTTTTTTTTTTTTTTOOOOXXXXXXXXXOOOOOLLLLLLLLLOOOOTTTTTTTTTTTTTTTTT
TTTTTTTTTTTTTTTTTOOOXXXXXXXXXXOOOOOLLLLLLLLLLOOOTTTTTTTTTTTTTTTTT
TTTTTTTTTTTTTTTTTOOOXXXXXXXXXOOOOOOOLLLLLLLLLOOOTTTTTTTTTTTTTTTTT
TTTTTTTTTTTTTTTTOOOOXXXXXXXOOOOOTOOOOOLLLLLLLOOOOTTTTTTTTTTTTTTTT
TTTTTTTTTTTTTTTTOOOXXXXXXXOOOOOTTTOOOOOLLLLLLLOOOTTTTTTTTTTTTTTTT
TTTTTTTTTTTTTTTTOOOXXXXXXOOOOOTTTTTOOOOOLLLLLLOOOTTTTTTTTTTTTTTTT
TTTTTTTTTTTTTTTOOOOXXXXXOOOOTTTTTTTTTOOOOLLLLLOOOOTTTTTTTTTTTTTTT
TTTTTTTTTTTTTTTOOOXXXXOOOOOTTTTTTTTTTTOOOOOLLLLOOOTTTTTTTTTTTTTTT
TTTTTTTTTTTTTTTOOOXXXOOOOOTTTTTTTTTTTTTOOOOOLLLOOOTTTTTTTTTTTTTTT
TTTTTTTTTTTTTTOOOOXXOOOOOTTTTTTTTTTTTTTTOOOOOLLOOOOTTTTTTTTTTTTTT
TTTTTTTTTTTTTTOOOXXOOOOTTTTTTTTTTTTTTTTTTTOOOOLLOOOTTTTTTTTTTTTTT
TTTTTTTTTTTTTTOOO3OOOOTTTTTTTTTTTTTTTTTTTTTOOOO7OOOTTTTTTTTTTTTTT
TTTTTTTTTTTTTOOO3OOOOTTTTTTTTTTTTTTTTTTTTTTTOOOO7OOOTTTTTTTTTTTTT
TTTTTTTTTTTTTOO3OOOOTTTTTTTTTTTTTTTTTTTTTTTTTOOOO7OOTTTTTTTTTTTTT
TTTTTTTTTTTTOOO3OOTTTTTTTTTTTTTTTTTTTTTTTTTTTTTOO7OOOTTTTTTTTTTTT
TTTTTTTTTTTTOO3OOTTTTTTTTTTTTTTTTTTTTTTTTTTTTTTTOO7OOTTT1T135557T
TTTTTTTTTTTTT3OOTTTTTTTTTTTTTTTTTTTTTTTTTTTTTTTTTOO7TTTT1T13T5T7T
TTTTTTTTTTTTTTTTTTTTTTTTTTTTTTTTTTTTTTTTTTTTTTTTTTTTTTTT111335T7T
TTTTTTTTTTTTTTTTTTTTTTTTTTTTTTTTTTTTTTTTTTTTTTTTTTTTTTTTTTTTTTTTT