XXXXXXXXXXXXXXXXXXXXXXXXXXXXXXXXXXXXXXXXXXXXXXXXXXXXXX
XXXXXXXXXXXXXXXXXXXXXXXXXXXXXXXXXXXXXXXXXXXXXXXXXXXXXX
XXXXXXXXXXXXXXXXXXXOOOOOOOOOOOOOOOOXXXXXXXXXXXXXXXXXXX
XXXXXXXXXXXXXXOOOOOOOOOOOXXXXOOOOOOOOOOOXXXXXXXXXXXXXX
XXXXXXXXXXXXXOOOOOOOOOOOOOOOOOOOOOOOOOOOOXXXXXXXXXXXXX
XXXXXXXXXXXOOOOOOOOOOOOOOXXXXOOOOOOOOOOOOOOXXXXXXXXXXX
XXXXXXXXXXOOOOOOOOOOOOOOOOOOOOOOOOOOOOOOOOOOXXXXXXXXXX
XXXXXXXXOOOOOOOOOOOOOOOOXXXXXXOOOOOOOOOOOOOOOOXXXXXXXX
XXXXXXXOOOOOOOOOOOOOOOOOOOOOOOOOOOOOOOOOOOOOOOOXXXXXXX
XXXXXXXOOOOOOOOOOOOOOOOOXXXXXXOOOOOOOOOOOOOOOOOXXXXXXX
XXXXXXOOOOOOOOOOOOOOOOOOOOOOOOOOOOOOOOOOOOOOOOOOXXXXXX
XXXXXOOOOOOOOOOOOOOOOOOXXXXXXXXOOOOOOOOOOOOOOOOOOXXXXX
XXXXXOOOOOOOOOOOOOOOOOOOOOOOOOOOOOOOOOOOOOOOOOOOOXXXXX
XXXXOOOOOOOOOOOOOOOOOOOXXXXXXXXOOOOOOOOOOOOOOOOOOOXXXX
XXXOOOOOOOOOOOOOOOOOOOOOOOOOOOOOOOOOOOOOOOOOOOOOOOOXXX
XXXOOOOOOOOOOOOOOOOOOOXXXXXXXXXXOOOOOOOOOOOOOOOOOOOXXX
XXXOOOOOOOOOOOOOOOOOOOOOOOOOOOOOOOOOOOOOOOOOOOOOOOOXXX
XXXOOOOOOOOOOOOOOOOOOOXXXXXXXXXXOOOOOOOOOOOOOOOOOOOXXX
XXXOOOOOOOOOOOOOOOOOOOOOOOOOOOOOOOOOOOOOOOOOOOOOOOOXXX
XXOOOOOOOOOOOOOXXXXXXXXXXXXXXXXXXXXXXXXOOOOOOOOOOOOOXX
XXOOOOOOOOOOOOXXXXXXXXXXXXXXXXXXXXXXXXXXOOOOOOOOOOOOXX
XXOOOOOOOOOOOOXXXXXXXXXXXXXXXXXXXXXXXXXXOOOOOOOOOOOOXX
XXOOOOOOOOOOOOXXXXXXXXXXXXXXXXXXXXXXXXXXOOOOOOOOOOOOXX
XXOOOOOOOOOOOOOXXXXXXXXXXXXXXXXXXXXXXXXOOOOOOOOOOOOOXX
XXXOOOOOOOOOOOOOOOOOOOOOOOXXOOOOOOOOOOOOOOOOOOOOOOOXXX
XXXOOOOOOOOOOOOOOOOOOOXXXXXXXXXXOOOOOOOOOOOOOOOOOOOXXX
XXXOOOOOOOOOOOOOOOOOOOOOOOXXOOOOOOOOOOOOOOOOOOOOOOOXXX
XXXOOOOOOOOOOOOOOOOOOOXXXXXXXXXXOOOOOOOOOOOOOOOOOOOXXX
XXXOOOOOOOOOOOOOOOOOOOOOOOXXOOOOOOOOOOOOOOOOOOOOOOOXXX
XXXXOOOOOOOOOOOOOOOOOOOXXXXXXXXOOOOOOOOOOOOOOOOOOOXXXX
XXXXXOOOOOOOOOOOOOOOOOOOOOXXOOOOOOOOOOOOOOOOOOOOOXXXXX
XXXXXOOOOOOOOOOOOOOOOOOXXXXXXXXOOOOOOOOOOOOOOOOOOXXXXX
XXXXXXOOOOOOOOOOOOOOOOOOOOXXOOOOOOOOOOOOOOOOOOOOXXXXXX
XXXXXXXOOOOOOOOOOOOOOOOOXXXXXXOOOOOOOOOOOOOOOOOXXXXXXX
XXXXXXXOOOOOOOOOOOOOOOOOOOXXOOOOOOOOOOOOOOOOOOOXXXXXXX
XXXXXXXXOOOOOOOOOOOOOOOOXXXXXXOOOOOOOOOOOOOOOOXXXXXXXX
XXXXXXXXXXOOOOOOOOOOOOOOOOXXOOOOOOOOOOOOOOOOXXXXXXXXXX
XXXXXXXXXXXOOOOOOOOOOOOOOXXXXOOOOOOOOOOOOOOXXXXXXXXXXX
XXXXXXXXXXXXXOOOOOOOOOOOOOXXOOOOOOOOOOOOOXXXXXXXXXXXXX
XXXXXXXXXXXXXXOOOOOOOOOOOXXXXOOOOOOOOOOOXXXXXXXXXXXXXX
XXXXXXXXXXXXXXXXXXXOOOOOOOXXOOOOOOOXXXXXXXXXXXXXXXXXXX
XXXXXXXXXXXXXXXXXXXXXXXXXXXXXXXXXXXXXXXXXXXXXXXXXXXXXX
XXXXXXXXXXXXXXXXXXXXXXXXXXXXXXXXXXXXXXXXXXXXXXXXXXXXXX