PPPPPPPPPPPPPPPPPPPPPPPPPPPPPPPPPPPPPPPPPPPPPPPPPPPPPP
PPPPPPPPPPPPPPPPPPPPPPPPPPPPPPPPPPPPPPPPPPPPPPPPPPPPPP
PPPPPPPPPPPPPPPPPPPOOOOOOO11OOOOOOOPPPPPPPPPPPPPPPPPPP
PPPPPPPPPPPPPPOOOOOOOOOOOPPPPOOOOOOOOOOOPPPPPPPPPPPPPP
PPPPPPPPPPPPPOOOOOOOOOOOOO22OOOOOOOOOOOOOPPPPPPPPPPPPP
PPPPPPPPPPPOOOOOOOOOOOOOOPPPPOOOOOOOOOOOOOOPPPPPPPPPPP
PPPPPPPPPPOOOOOOOOOOOOOOOO33OOOOOOOOOOOOOOOOPPPPPPPPPP
PPPPPPPPOOOOOOOOOOOOOOOOPPPPPPOOOOOOOOOOOOOOOOPPPPPPPP
PPPPPPPOOOOOOOOOOOOOOOOOOO44OOOOOOOOOOOOOOOOOOOPPPPPPP
PPPPPPPOOOOOOOOOOOOOOOOOPPPPPPOOOOOOOOOOOOOOOOOPPPPPPP
PPPPPPOOOOOOOOOOOOOOOOOOOO55OOOOOOOOOOOOOOOOOOOOPPPPPP
PPPPPOOOOOOOOOOOOOOOOOOPPPPPPPPOOOOOOOOOOOOOOOOOOPPPPP
PPPPPOOOOOOOOOOOOOOOOOOOOO66OOOOOOOOOOOOOOOOOOOOOPPPPP
PPPPOOOOOOOOOOOOOOOOOOOPPPPPPPPOOOOOOOOOOOOOOOOOOOPPPP
PPPOOOOOOOOOOOOOOOOOOOOOOO77OOOOOOOOOOOOOOOOOOOOOOOPPP
PPPOOOOOOOOOOOOOOOOOOOPPPPPPPPPPOOOOOOOOOOOOOOOOOOOPPP
PPPOOOOOOOOOOOOOOOOOOOOOOO88OOOOOOOOOOOOOOOOOOOOOOOPPP
PPPOOOOOOOOOOOOOOOOOOOPPPPPPPPPPOOOOOOOOOOOOOOOOOOOPPP
PPPOOOOOOOOOOOOOOOOOOOOOOO99OOOOOOOOOOOOOOOOOOOOOOOPPP
PPOOOOOOOOOOOOOPPPPPPPPPPPPPPPPPPPPPPPPOOOOOOOOOOOOOPP
PPOOOOOOOOOOOOPP1P12333455555666777888PPOOOOOOOOOOOOPP
PPOOOOOOOOOOOOPP1P12P3P45P5P5666P7P88PPPOOOOOOOOOOOOPP
PPOOOOOOOOOOOOPP111223P45PPP56P6P7P888PPOOOOOOOOOOOOPP
PPOOOOOOOOOOOOOPPPPPPPPPPPPPPPPPPPPPPPPOOOOOOOOOOOOOPP
PPPOOOOOOOOOOOOOOOOOOOOOOOSFOOOOOOOOOOOOOOOOOOOOOOOPPP
PPPOOOOOOOOOOOOOOOOOOOPPPPPPPPPPOOOOOOOOOOOOOOOOOOOPPP
PPPOOOOOOOOOOOOOOOOOOOOOOOSFOOOOOOOOOOOOOOOOOOOOOOOPPP
PPPOOOOOOOOOOOOOOOOOOOPPPPPPPPPPOOOOOOOOOOOOOOOOOOOPPP
PPPOOOOOOOOOOOOOOOOOOOOOOOSFOOOOOOOOOOOOOOOOOOOOOOOPPP
PPPPOOOOOOOOOOOOOOOOOOOPPPPPPPPOOOOOOOOOOOOOOOOOOOPPPP
PPPPPOOOOOOOOOOOOOOOOOOOOOSFOOOOOOOOOOOOOOOOOOOOOPPPPP
PPPPPOOOOOOOOOOOOOOOOOOPPPPPPPPOOOOOOOOOOOOOOOOOOPPPPP
PPPPPPOOOOOOOOOOOOOOOOOOOOSFOOOOOOOOOOOOOOOOOOOOPPPPPP
PPPPPPPOOOOOOOOOOOOOOOOOPPPPPPOOOOOOOOOOOOOOOOOPPPPPPP
PPPPPPPOOOOOOOOOOOOOOOOOOOSFOOOOOOOOOOOOOOOOOOOPPPPPPP
PPPPPPPPOOOOOOOOOOOOOOOOPPPPPPOOOOOOOOOOOOOOOOPPPPPPPP
PPPPPPPPPPOOOOOOOOOOOOOOOOSFOOOOOOOOOOOOOOOOPPPPPPPPPP
PPPPPPPPPPPOOOOOOOOOOOOOOPPPPOOOOOOOOOOOOOOPPPPPPPPPPP
PPPPPPPPPPPPPOOOOOOOOOOOOOSFOOOOOOOOOOOOOPPPPPPPPPPPPP
PPPPPPPPPPPPPPOOOOOOOOOOOPPPPOOOOOOOOOOOPPPPPPPPPPPPPP
PPPPPPPPPPPPPPPPPPPOOOOOOOSFOOOOOOOPPPPPPPPPPPPPPPPPPP
PPPPPPPPPPPPPPPPPPPPPPPPPPPPPPPPPPPPPPPPPPPPPPPPPPPPPP
PPPPPPPPPPPPPPPPPPPPPPPPPPPPPPPPPPPPPPPPPPPPPPPPPPPPPP