PXXXXXXXXXXXXXXXXXXXXXXXXXXXXXXXXXXXXXXXXXXXXXXXXXXXXX
PXXXXXXXXXXXXXXXXXXXXXXXXXXXXXXXXXXXXXXXXXXXXXXXXXXXXX
PXXXXXXXXXXXXXXXXXXOOOOOOO11OOOOOOOXXXXXXXXXXXXXXXXXXX
PXXXXXXXXXXXXXOOOOOOOOOOOPPPPOOOOOOOOOOOXXXXXXXXXXXXXX
PXXXXXXXXXXXXOOOOOOOOOOOOO22OOOOOOOOOOOOOXXXXXXXXXXXXX
PXXXXXXXXXXOOOOOOOOOOOOOOPPPPOOOOOOOOOOOOOOXXXXXXXXXXX
PXXXXXXXXXOOOOOOOOOOOOOOOO33OOOOOOOOOOOOOOOOXXXXXXXXXX
PXXXXXXXOOOOOOOOOOOOOOOOPPPPPPOOOOOOOOOOOOOOOOXXXXXXXX
PXXXXXXOOOOOOOOOOOOOOOOOOO44OOOOOOOOOOOOOOOOOOOXXXXXXX
XXXXXXXOOOOOOOOOOOOOOOOOPPPPPPOOOOOOOOOOOOOOOOOXXXXXXX
XXXXXXOOOOOOOOOOOOOOOOOOOO55OOOOOOOOOOOOOOOOOOOOXXXXXX
XXXXXOOOOOOOOOOOOOOOOOOPPPPPPPPOOOOOOOOOOOOOOOOOOXXXXX
XXXXXOOOOOOOOOOOOOOOOOOOOO66OOOOOOOOOOOOOOOOOOOOOXXXXX
XXXXOOOOOOOOOOOOOOOOOOOPPPPPPPPOOOOOOOOOOOOOOOOOOOXXXX
XXXOOOOOOOOOOOOOOOOOOOOOOO77OOOOOOOOOOOOOOOOOOOOOOOXXX
XXXOOOOOOOOOOOOOOOOOOOPPPPPPPPPPOOOOOOOOOOOOOOOOOOOXXX
XXXOOOOOOOOOOOOOOOOOOOOOOO88OOOOOOOOOOOOOOOOOOOOOOOXXX
XXXOOOOOOOOOOOOOOOOOOOPPPPPPPPPPOOOOOOOOOOOOOOOOOOOXXX
XXXOOOOOOOOOOOOOOOOOOOOOOO99OOOOOOOOOOOOOOOOOOOOOOOXXX
XXOOOOOOOOOOOOOPPPPPPPPPPPPPPPPPPPPPPPPOOOOOOOOOOOOOXX
XXOOOOOOOOOOOOPP1X12333455555666777888PPOOOOOOOOOOOOXX
XXOOOOOOOOOOOOPX1X12X3X45X5X5666X7X88XXPOOOOOOOOOOOOXX
XXOOOOOOOOOOOOPP111223X45XXX56X6X7X888PPOOOOOOOOOOOOXX
XXOOOOOOOOOOOOOPPPPPPPPPPPPPPPPPPPPPPPPOOOOOOOOOOOOOXX
XXXOOOOOOOOOOOOOOOOOOOOOOOSFOOOOOOOOOOOOOOOOOOOOOOOXXX
XXXOOOOOOOOOOOOOOOOOOOPPPPPPPPPPOOOOOOOOOOOOOOOOOOOXXX
XXXOOOOOOOOOOOOOOOOOOOOOOOSFOOOOOOOOOOOOOOOOOOOOOOOXXX
XXXOOOOOOOOOOOOOOOOOOOPPPPPPPPPPOOOOOOOOOOOOOOOOOOOXXX
XXXOOOOOOOOOOOOOOOOOOOOOOOSFOOOOOOOOOOOOOOOOOOOOOOOXXX
XXXXOOOOOOOOOOOOOOOOOOOPPPPPPPPOOOOOOOOOOOOOOOOOOOXXXX
XXXXXOOOOOOOOOOOOOOOOOOOOOSFOOOOOOOOOOOOOOOOOOOOOXXXXX
XXXXXOOOOOOOOOOOOOOOOOOPPPPPPPPOOOOOOOOOOOOOOOOOOXXXXX
XXXXXXOOOOOOOOOOOOOOOOOOOOSFOOOOOOOOOOOOOOOOOOOOXXXXXX
XXXXXXXOOOOOOOOOOOOOOOOOPPPPPPOOOOOOOOOOOOOOOOOXXXXXXX
XXXXXXXOOOOOOOOOOOOOOOOOOOSFOOOOOOOOOOOOOOOOOOOXXXXXXX
XXXXXXXXOOOOOOOOOOOOOOOOPPPPPPOOOOOOOOOOOOOOOOXXXXXXXX
XXXXXXXXXXOOOOOOOOOOOOOOOOSFOOOOOOOOOOOOOOOOXXXXXXXXXX
XXXXXXXXXXXOOOOOOOOOOOOOOPPPPOOOOOOOOOOOOOOXXXXXXXXXXX
XXXXXXXXXXXXXOOOOOOOOOOOOOSFOOOOOOOOOOOOOXXXXXXXXXXXXX
XXXXXXXXXXXXXXOOOOOOOOOOOPPPPOOOOOOOOOOOXXXXXXXXXXXXXX
XXXXXXXXXXXXXXXXXXXOOOOOOOSFOOOOOOOXXXXXXXXXXXXXXXXXXX
XXXXXXXXXXXXXXXXXXXXXXXXXXXXXXXXXXXXXXXXXXXXXXXXXXXXXX
XXXXXXXXXXXXXXXXXXXXXXXXXXXXXXXXXXXXXXXXXXXXXXXXXXXXXX