PPPPPPPPPPPPPPPPPPPPPPPPPPPPPPPPPPPPPPPPPPPPPPPPPPPPPPPPPPPPPPPPPPPPPPPPPPPPPPPPPPPPPPPPPPPPPPPPPPPPPPPPPPPPPPPPPPPPPPPPPPPPPPPPPPPPPPPPPPPPP
PFOOOOOOOOOOOOOOOOOOOOOOOOOOOOOOOOOOOOOOOOOOOOOOOOOOOOOOOOOOOOOOOOOOOOOOOOOOOOOOOOOOOOOOOOOOOOOOOOOOOOOOOOOOOOOOOOOOOOOOOOOOOOOOOOOOOOOOOOOFP
PSOOOOOOOOOOOOOOOOOOOOOOOOOOOOOOOOOOOOOOOOOOOOOOOOOOOOOOOOOOOOOOOOOOOOOOOOOOOOOOOOOOOOOOOOOOOOOOOOOOOOOOOOOOOOOOOOOOOOOOOOOOOOOOOOOOOOOOOOOSP
PSOOOOOOOOOOOOOOOOOOOOOOOOOOOOOOOOOOOOOOOOOOOOOOOOOOOOOOOOOOOOOOOOOOOOOOOOOOOOOOOOOOOOOOOOOOOOOOOOOOOOOOOOOOOOOOOOOOOOOOOOOOOOOOOOOOOOOOOOOSP
PSOOOOLLLOOOOOOOOOOOOOOWWWWWO99999OYYYYYOOOOOOOOOOOGGGOOOOOOOOOOOOOOOOOOOO6OOOOOOOOONNNOO7OOOOOOOOOOO333OOO111OOOOOOOOOOOOOOOOOOOOOOOOOOOOOSP
PFOOOLOOOLOOOOOOOOOOOOOOOOOWOOOOO9OOOOOYOOOOOOOOOOGOOOGOOOOOOOOOOOOOOOOOOO6OOOOOOOONOOONO7OOOOOOOOOOOOO3OOOOO1OOOOOOOOOOOOOOOOOOOOOOOOOOOOOFP
PFOOOLOOOOO5555OOOXXXOOOOOWOOOOO9OOOOOYOO8OOO8OOOOGOOOOO4444OOO222OOOZZZZO6666OOOOONOOOOO7777OOOTTTOOOO3OOOOO1OOOOGGGOO9999OOOXXXXOO555OOOOFP
PFOOOLOOOOO5OOO5OOOOOXOOOWOOOOO9OOOOOYOOO8OOO8OOOOGOOOOO4OOO4OOOOO2OZOOOOO6OOO6OOOONOOOOO7OOO7OOOOOTOOO3OOOOO1OOOGOOOGO9OOO9OXOOOXO5OOO5OOOFP
PFOOOLOOOOO5OOOOOOXXXXOOWOOOOO9OOOOOYOOOO8OOO8OOOOGOOOOO4OOOOOO2222OOZZZOO6OOO6OOOONOOOOO7OOO7OOTTTTOOO3OOOOO1OOOGGGGGO9OOO9OXOOOXO55555OOOFP
PFOOOLOOOLO5OOOOOXOOOXOWOOOOO9OOOOOYOOOOO8OOO8OOOOGOOOGO4OOOOO2OOO2OOOOOZO6OOO6OOOONOOONO7OOO7OTOOOTOOO3OOOOO1OOOGOOOOO9OOO9OXOOOXO5OOOOOOOFP
PSOOOOLLLOO5OOOOOOXXXXOWWWWWO99999OYYYYYOO8888OOOOOGGGOO4OOOOOO2222OZZZZOO6OOO6OOOOONNNOO7OOO7OOTTTTO33333O11111OOGGGOO9OOO9OOXXXXOO555OOOOSP
PSOOOOOOOOOOOOOOOOOOOOOOOOOOOOOOOOOOOOOOOOOOO8OOOOOOOOOOOOOOOOOOOOOOOOOOOOOOOOOOOOOOOOOOOOOOOOOOOOOOOOOOOOOOOOOOOOOOOOOOOOOOOOOOOXOOOOOOOOOSP
PSOOOOOOOOOOOOOOOOOOOOOOOOOOOOOOOOOOOOOOOO888OOOOOOOOOOOOOOOOOOOOOOOOOOOOOOOOOOOOOOOOOOOOOOOOOOOOOOOOOOOOOOOOOOOOOOOOOOOOOOOOOXXXOOOOOOOOOOSP
PFOOOOOOOOOOOOOOOOOOOOOOOOOOOOOOOOOOOOOOOOOOOOOOOOOOOOOOOOOOOOOOOOOOOOOOOOOOOOOOOOOOOOOOOOOOOOOOOOOOOOOOOOOOOOOOOOOOOOOOOOOOOOOOOOOOOOOOOOOFP
PPPPPPPPPPPPPPPPPPPPPPPPPPPPPPPPPPPPPPPPPPPPPPPPPPPPPPPPPPPPPPPPPPPPPPPPPPPPPPPPPPPPPPPPPPPPPPPPPPPPPPPPPPPPPPPPPPPPPPPPPPPPPPPPPPPPPPPPPPPPP