PPPPPPPPPPPPPPPPPPPPPPPPPPPPPPPPPPPPPPPPPPPPPPPPPPPPPPPPPPPPPPPPPPPPPPPPPPPPPPPPPPPPPPPPPPPPPPPPPPPPPPPPPPPPPPPPPPPPPPPPPPPPPPPPPPPPPPPPPPPPP
PSOOOOOOOOOOOOOOOOOOOOOOOOOOOOOOOOOOOOOOOOOOOOOOOOOOOOOOOOOOOOOOOOOOOOOOOOOOOOOOOOOOOOOOOOOOOOOOOOOOOOOOOOOOOOOOOOOOOOOOOOOOOOOOOOOOOOOOOOOFP
PSOOOOOOOOOOOOOOOOOOOOOOOOOOOOOOOOOOOOOOOOOOOOOOOOOOOOOOOOOOOOOOOOOOOOOOOOOOOOOOOOOOOOOOOOOOOOOOOOOOOOOOOOOOOOOOOOOOOOOOOOOOOOOOOOOOOOOOOOOFP
PSOOOOOOOOOOOOOOOOOOOOOOOOOOOOOOOOOOOOOOOOOOOOOOOOOOOOOOOOOOOOOOOOOOOOOOOOOOOOOOOOOOOOOOOOOOOOOOOOOOOOOOOOOOOOOOOOOOOOOOOOOOOOOOOOOOOOOOOOOFP
PSOOOOLLLOOOOOOOOOOOOOOWWWWWO99999OYYYYYOOOOOOOOOOOGGGOOOOOOOOOOOOOOOOOOOO6OOOOOOOOONNNOO7OOOOOOOOOOO333OOO111OOOOOOOOOOOOOOOOOOOOOOOOOOOOOFP
PPOOOLOOOLOOOOOOOOOOOOOOOOOWOOOOO9OOOOOYOOOOOOOOOOGOOOGOOOOOOOOOOOOOOOOOOO6OOOOOOOONOOONO7OOOOOOOOOOOOO3OOOOO1OOOOOOOOOOOOOOOOOOOOOOOOOOOOOPP
PPOOOLOOOOO5555OOOXXXOOOOOWOOOOO9OOOOOYOO8OOO8OOOOGOOOOO4444OOO222OOOZZZZO6666OOOOONOOOOO7777OOOTTTOOOO3OOOOO1OOOOGGGOO9999OOOXXXXOO555OOOOPP
PPOOOLOOOOO5OOO5OOOOOXOOOWOOOOO9OOOOOYOOO8OOO8OOOOGOOOOO4OOO4OOOOO2OZOOOOO6OOO6OOOONOOOOO7OOO7OOOOOTOOO3OOOOO1OOOGOOOGO9OOO9OXOOOXO5OOO5OOOPP
PPOOOLOOOOO5OOOOOOXXXXOOWOOOOO9OOOOOYOOOO8OOO8OOOOGOOOOO4OOOOOO2222OOZZZOO6OOO6OOOONOOOOO7OOO7OOTTTTOOO3OOOOO1OOOGGGGGO9OOO9OXOOOXO55555OOOPP
PPOOOLOOOLO5OOOOOXOOOXOWOOOOO9OOOOOYOOOOO8OOO8OOOOGOOOGO4OOOOO2OOO2OOOOOZO6OOO6OOOONOOONO7OOO7OTOOOTOOO3OOOOO1OOOGOOOOO9OOO9OXOOOXO5OOOOOOOPP
PSOOOOLLLOO5OOOOOOXXXXOWWWWWO99999OYYYYYOO8888OOOOOGGGOO4OOOOOO2222OZZZZOO6OOO6OOOOONNNOO7OOO7OOTTTTO33333O11111OOGGGOO9OOO9OOXXXXOO555OOOOFP
PSOOOOOOOOOOOOOOOOOOOOOOOOOOOOOOOOOOOOOOOOOOO8OOOOOOOOOOOOOOOOOOOOOOOOOOOOOOOOOOOOOOOOOOOOOOOOOOOOOOOOOOOOOOOOOOOOOOOOOOOOOOOOOOOXOOOOOOOOOFP
PSOOOOOOOOOOOOOOOOOOOOOOOOOOOOOOOOOOOOOOOO888OOOOOOOOOOOOOOOOOOOOOOOOOOOOOOOOOOOOOOOOOOOOOOOOOOOOOOOOOOOOOOOOOOOOOOOOOOOOOOOOOXXXOOOOOOOOOOFP
PSOOOOOOOOOOOOOOOOOOOOOOOOOOOOOOOOOOOOOOOOOOOOOOOOOOOOOOOOOOOOOOOOOOOOOOOOOOOOOOOOOOOOOOOOOOOOOOOOOOOOOOOOOOOOOOOOOOOOOOOOOOOOOOOOOOOOOOOOOFP
PPPPPPPPPPPPPPPPPPPPPPPPPPPPPPPPPPPPPPPPPPPPPPPPPPPPPPPPPPPPPPPPPPPPPPPPPPPPPPPPPPPPPPPPPPPPPPPPPPPPPPPPPPPPPPPPPPPPPPPPPPPPPPPPPPPPPPPPPPPPP