PPPPPPPPPPPPPPPPPPPPPPPPPPPPPPPPPPPPPPPPPPPPPPPPPPPPPP
PNNNNNNNNNNNNNNNNNNNNNNNNNNNNNNNNNNNNNNNNNNNNNNNNNNNNP
PNNNNN44NNNNNNNNNNNNNNNNNNNNNNNNNNNNNNNNNNNNNNNNNNNNNP
PNNNNNOONNNNNNNNNNNNNNNNNNNNNNNNNNNNNNNNNNNNNNNNNNNNNP
PNNNNNOONNNNNNNNNNNNNNNNNNNNNNNNNNNNNNNNNNNNNNNNNNNNNP
PNNNNNOONNNNNNNNNNNNNNNNNNNNNNNNNNNNNNNNNNNNNNNNNNNNNP
PNNNNNOONNNNNNNNNNNNNNNNNNNNNNNNNNNNNNNNNNNNNNNNNNNNNP
PNNNNNOONNNNNNNNNNNNNNNNNNNNNNNNNNNNNNNNNNNNNNNNNNNNNP
PNNOOOOONNFOOOSOOOOOOOOOOOOOOOOOOOOOOOOOOOOOOOOSOOOFNP
PNOOOOOONNFOOOSOOOOOOOOOOOOOOOOOOOOOOOOOOOOOOOOSOOOFNP
PNOOOOOONNNNNNNNNNNNOOOOOOOOOOOOOOOOOOOOOONNNNNNOONNNP
PNOOOOOONNNNNNNNNNNNOOOOOOOOOOOOOOOOOOOOOONNNNNNOONNNP
PNOOOOOONNNNNNNNNNNNOOOOOOOOOOOOOOOOOOOOOONNNNNNOONNNP
PNOOOOOONNNNNNNNNNNNOOOOOOOOOOOOOOOOOOOOOONNNNNNOONNNP
PNOOOOOONNNNNNNNNNNNOOOOOOOOOOOOOOOOOOOOOONNNNNOOOONNP
PNNOOOONNNNNNNNNNNN7OOOOOOOOOOOOOOOOOOOOOO9NNNOOOOOONP
PNNN88NNNNNNNNNNNN777GGG5555GGGGGG5555GGG999NNOOOOOONP
PNNN88NNNNNNNNNNNN77GGGGGGGGGGGGGGGGGGGGGG99NNNOOOONNP
PNNNOONNNNNNNNNNN777GGGGGTTGGGGGGGGTTGGGGG999NNNOONNNP
PNNNOONNNNNNNNNNN77GGGGGTTTTGGGGGGTTTTGGGGG99NNNOONNNP
PNNNOONNNNNNNNNNOO7GGGGGTTTTGGGGGGTTTTGGGGG9OONN22NNNP
PNNNOONNNNNNNNNNOOGGGGGGGTTGGGGGGGGTTGGGGGGGOONN22NNNP
PNNNOONNNNNNNNNNOOGGGGGGGGGGGGGGGGGGGGGGGGGGOONNNNNNNP
PNNNOOONNNNNNNNNOOGGGGGGGGGGGGGGGGGGGGGGGGGGOONNNNNNNP
PNNNOOOOOOOOOOOOOOGGGGGGGGGGGGGGGGGGGGGGGGGGOONNNNNNNP
PNNNNOOOOOOOOOOOOOGGGGGGGGGGGGGGGGGGGGGGGGGGOONNNNNNNP
PNNNNNNNNNNNNNNNOOGGGGGGGGGGGGGGGGGGGGGGGGGGOONNNNNNNP
PNNNNNNNNNNNNNNNOOGGGGGGGGGGGGGGGGGGGGGGGGGGOONNNNNNNP
PNNNNNNNNNNNNNNNOOGGGGGGGGGGGGGGGGGGGGGGGGGGOONNNNNNNP
PNNNNNNNNNNNNNNNOO1GGGGGGGGGGGGGGGGGGGGGGGG3OONNNNNNNP
PNNNNNNNNNNNNNNNN11GGGGGGTTTTTTTTTTTTGGGGGG33NNNNNNNNP
PNNNNNNNNNNNNNNNN111GGGGTTTTTTTTTTTTTTGGGG333NNNNNNNNP
PNNNNNNNNNNNNNNNNN11GGGGGTTTTTTTTTTTTGGGGG33NNNNNNNNNP
PNNNNNNNNNNNNNNNNN111GGGGGGTTTTTTTTGGGGGG333NNNNNNNNNP
PNNNNNNNNNNNNNNNNNN1OOGGGGGGGGGGGGGGGGGGOO3NNNNNNNNNNP
PNNNNNNNNNNNNNNNNNNNOOOGGGGGGGGGGGGGGGGOOONNNNNNNNNNNP
PNNNNNNNNNNNNNNNNNNNNOOOOGGGGGGGGGGGGOOOONNNNNNNNNNNNP
PNNNNNNNNNNNNNNNNNNNNNOOOOOGGGGGGGGOOOOONNNN1N123334NP
PNNNNNNNNNNNNNNNNNNNNNNNOOOOOOOOOOOOOONNNNNN1N12N3N4NP
PNNNNNNNNNNNNNNNNNNNNNNNNNOOOOOOOOOONNNNNNNN111223N4NP
PNNNNNNNNNNNNNNNNNNNNNNNNNNNNNNNNNNNNNNNNNNNNNNNNNNNNP
PPPPPPPPPPPPPPPPPPPPPPPPPPPPPPPPPPPPPPPPPPPPPPPPPPPPPP