PPPPPPPPPPPPPPPPPPPPPPPPPPPPPPPPPPP
PPPPPPPPPPPPPPPPPPPPPPPPPPPPPPPPPPP
PPPPPPPPPPPPPPPSSSSSPPPPPPPPPPPPPPP
PPPPPPPPPPPSSSSOOOOOSSSSPPPPPPPPPPP
PPPPPPPPPPSOOOOOOOOOOOOOSPPPPPPPPPP
PPPPPPPPSSOOOOOOOOOOOOOOOSSPPPPPPPP
PPPPPPPSOOOOOOOOOOOOOOOOOOOSPPPPPPP
PPPPPPSOOOOOOOOOOOOOOOOOOOOOSPPPPPP
PPPPPSOOOOOOOOOOOOOOOOOOOOOOOSPPPPP
PPPPPSOOOOOOOOOOO1OOOOOOOOOOOSPPPPP
PPPPSOOOOOOOOOOOOOOOOOOOOOOOOOSPPPP
PPPSOOOOOOO8OOOOOOOOOOO2OOOOOOOSPPP
PPPSOOOOOOOOOOOOOOOOOOOOOOOOOOOSPPP
PPPSOOOOOOOOOOOOOOOOOOOOOOOOOOOSPPP
PPPSOOOOOOOOOOOOOOOOOOOOOOOOOOOSPPP
PPSOOOOOOOOOOOOOOOOOOOOOOOOOOOOOSPP
PPSOOOOOOOOOOOOOOOOOOOOOOOOOOOOOSPP
PPSOOOOOO7OOOOOOOFOOOOOOO3OOOOOOSPP
PPSOOOOOOOOOOOOOOOOOOOOOOOOOOOOOSPP
PPSOOOOOOOOOOOOOOOOOOOOOOOOOOOOOSPP
PPPSOOOOOOOOOOOOOOOOOOOOOOOOOOOSPPP
PPPSOOOOOOOOOOOOOOOOOOOOOOOOOOOSPPP
PPPSOOOOOOOOOOOOOOOOOOOOOOOOOOOSPPP
PPPSOOOOOOO6OOOOOOOOOOO4OOOOOOOSPPP
PPPPSOOOOOOOOOOOOOOOOOOOOOOOOOSPPPP
PPPPPSOOOOOOOOOOO5OOOOOOOOOOOSPPPPP
PPPPPSOOOOOOOOOOOOOOOOOOOOOOOSPPPPP
PPPPPPSOOOOOOOOOOOOOOOOOOOOOSPPPPPP
PPPPPPPSOOOOOOOOOOOOOOOOOOOSPPPPPPP
PPPPPPPPSSOOOOOOOOOOOOOOOSSPPPPPPPP
PPPPPPPPPPSOOOOOOOOOOOOOSPPPPPPPPPP
PPPPPPPPPPPSSSSOOOOOSSSSPP1P123334P
PPPPPPPPPPPPPPPSSSSSPPPPPP1P12P3P4P
PPPPPPPPPPPPPPPPPPPPPPPPPP111223P4P
PPPPPPPPPPPPPPPPPPPPPPPPPPPPPPPPPPP