PPPPPPPPPPPPPPPPPPPPPPPPPPPPPPPPPPP
PPPPPPPPPPPPPPPPPPPPPPPPPPPPPPPPPPP
PPPPPPPPPPPPPPPSOOOSPPPPPPPPPPPPPPP
PPPPPPPPPPPSOOOOOOOOOOOSPPPPPPPPPPP
PPPPPPPPPPOOOOOOOOOOOOOOOPPPPPPPPPP
PPPPPPPPSOOOOOOOOOOOOOOOOOSPPPPPPPP
PPPPPPPOOOOOOOOOOOOOOOOOOOOOPPPPPPP
PPPPPPOOOOOOOOOOOOOOOOOOOOOOOPPPPPP
PPPPPSOOOOOOOOOOOOOOOOOOOOOOOSPPPPP
PPPPPOOOOOOOOOOOO1OOOOOOOOOOOOPPPPP
PPPPOOOOOOOOOOOOOOOOOOOOOOOOOOOPPPP
PPPSOOOOOOO8OOOOOOOOOOO2OOOOOOOSPPP
PPPOOOOOOOOOOOOOOOOOOOOOOOOOOOOOPPP
PPPOOOOOOOOOOOOOOOOOOOOOOOOOOOOOPPP
PPPOOOOOOOOOOOOOOOOOOOOOOOOOOOOOPPP
PPSOOOOOOOOOOOOOOOOOOOOOOOOOOOOOSPP
PPOOOOOOOOOOOOOOOOOOOOOOOOOOOOOOOPP
PPOOOOOOO7OOOOOOOFOOOOOOO3OOOOOOOPP
PPOOOOOOOOOOOOOOOOOOOOOOOOOOOOOOOPP
PPSOOOOOOOOOOOOOOOOOOOOOOOOOOOOOSPP
PPPOOOOOOOOOOOOOOOOOOOOOOOOOOOOOPPP
PPPOOOOOOOOOOOOOOOOOOOOOOOOOOOOOPPP
PPPOOOOOOOOOOOOOOOOOOOOOOOOOOOOOPPP
PPPSOOOOOOO6OOOOOOOOOOO4OOOOOOOSPPP
PPPPOOOOOOOOOOOOOOOOOOOOOOOOOOOPPPP
PPPPPOOOOOOOOOOOO5OOOOOOOOOOOOPPPPP
PPPPPSOOOOOOOOOOOOOOOOOOOOOOOSPPPPP
PPPPPPOOOOOOOOOOOOOOOOOOOOOOOPPPPPP
PPPPPPPOOOOOOOOOOOOOOOOOOOOOPPPPPPP
PPPPPPPPSOOOOOOOOOOOOOOOOOSPPPPPPPP
PPPPPPPPPPOOOOOOOOOOOOOOOPPPPPPPPPP
PPPPPPPPPPPSOOOOOOOOOOOSPP1P123334P
PPPPPPPPPPPPPPPSOOOSPPPPPP1P12P3P4P
PPPPPPPPPPPPPPPPPPPPPPPPPP111223P4P
PPPPPPPPPPPPPPPPPPPPPPPPPPPPPPPPPPP