XXXXXXXXXXX
XOOOOOOOOOX
XOSOSOSOSOX
XOOOOOOOOOX
XOSO000OSOX
XOOO0F0OOOX
XOSO000OSOX
XOOOOOOOOOX
XOSOSOSOSOX
XOOOOOOOOOX
XXXXXXXXXXX