XXXXXXXXXXXXXXXXXXXXXXXXXXXXXXXXXXXXXXXXXXXXXXXXXXXXXXXXXXXXXXXXXXXXXXXXXXXXXXXXXXXXXXXXXXXXXXXXXXXXXXXXXXXXXXXXXXXXXXXXXXXXXXXXXXXXXXXXXXXXXXXXXXXXXXXXXXXXXXXXXXXXXXXXXXXXXXXXXXXXXXXXXXXXXXXXXXXXXXXXXXXXXXXXXXXXXXXXXXXXXXXXXXXXXXXXXXXXXXXXXXXXXXXXXXXXXXXXXXXXXXXXXXXXXXXXXXXXXXXXXXXXXXXXXXXXXXXXXXXXXXXXXXXXXXXXXXXXXXXXXXXXXXXXXXXXXXXXXXXXXXXXXXXXXXXXXXXXXXXXXXXXXXXXXXXXXXXXXXXXXXXXXXXXXXXXXXXXXXXXXXXXXXXXXXXXXXXXXXXXXXXXXXXXXXXXXXXXXXXXXXXXXXXXXXXXXXXXXXXXXXXXXXXXXXXXXXXXXXXXXXXXXXXXXXXXXXXXXXXXXXXXXXXXXXXXXXXXXXXXXXXXXXXXXXXXXXXXXXXXXXXXXXXXXXXXXXXXXXXXXXXXXXXXXXXXXXXXXXXXXXXXXXXXXXXXXXXXXXXXXXXXXXXXXXXXXXXXXXXXXXXXXXXXXXXXXXXXXXXXXXXXXXXXXXXXXXXXXXXXXXXXXXXXXXXXXXXXXXXXXXXXXXXXXXXXXXXXXXXXXXXXXXXXXXXXXXXXXXXXXXXXXXXXXXXXXXXXXXXXXXXXXXXXXXXXXXXXXXXXXXXXXXXXXXXXXXXXXXXXXXXXXXXXXXXXXXXXXXXXXXXXXXXXXXXXXXXXXXXXXXXXXXXXXXXXXXXXXXXXXXXXXXXXXXXXXXXXXXXXXXXXXXXXXXXXXXXXXXXXXXXXXXXXXXXXXXXXXXXXXXXXXXXXXXXXXXXXXXXXXXXXXXXXXXXXXXXXXXXXXXXXXXXXXXXXXXXXXXXXXXXXXXXXXXXXXXXXXXXXXXXXXXXXXXXXXXXXXXXXXX
XSOOOOOOOXXXXXXXXOOO2OOOOOOOO3OOOOOOOOO4OOOOOOOO5OOOOOOOOO6OOOOOOOOO7OOOOXXXXXXXXXXXXXXXXXXXXXXXXXXXXXXXXXXXXXXXXXXXXXXXXXXXXXXXXXXXXXXXXXXXXXXXXXXXXXXXXXXOOOOOOOO8OOOOOOOOO9OOOOOOOOO1OOOOOOOO2OOOOOOXXXXXXOOOOOO4OOOOOOOOO5OOOOOOOOO6OOOOOOOO7OOOOOOOOO8OOOOOOOO9OOOOOOOOO1OOOOOXXXXXXXXXXXXXXXXXXXXXXXXXXXXXXXXXXXXXXXXXXXXXXXXXXXXXXXXXXXXXXXXXXXXXXXXXXXXXXXXXXXXXXXXXXXOOOOOOXX3OOOOOOOOO4OOOOOOOO5OOOOOOOOO6OOOOOOOOO7OOOOOOOO8OOOOOOOOOXXXXXXXXXXXXXXXXXXXXXXXXXXXXXXXXXXXXXXXXXXXXXXXXXXXXXXXXXXXXXXXXXXXXXXXXXXXXXXXXXXXXXXXXXXXXXXXXXXXXXXXXXXXXXXXXXXXXXXXXXXXXXXXXXXXXXXXXXXXXXXXXXXXXXXXXXXXXXXXXXXXXXXXXXXXXXXXXXXXXXXXXXXXXXXXXXXXXXXXXXXXXXXXXXXXXXXXXXXXXXXXXXXXXXXXXXXXXXXXXXXXXXXXXXXXXXXXXXXXXXXXXXXXXXXXXXXXXXXXXXXXXXXXXXXXXXXXXXXXXXXXXXXXXXXXXXXXXXXXXXXXXXXXXXXXXXXXXXXXXXXXXXXXXXXXXXXXXXXXXXXXXXXXXXXXXXXXXXXXXXXXXXXXXXXXXXXXXXXXXXXXXXXXXXXXXXXXXXXXXXXXXXXXXXXXXXXXXXXXXXXXXXXXXXXXXXXXXXXXXXXXXXXXXXXXXXXXXXXXXXXXXXXXXXXXXXXXXXXXXXXXXXXXXXXXXXXXXXXXXXXXXXXXXXXXXXXXXXXXXXXXXXXXXXXXXXXXXXXXXXXXXXXXXXX
XSOOOOOOOO1OOOOOOOOO2OOOOOOOO3OOOOOOOOO4OOOOOOOO5OOOOOOOOO6OOOOOOOOO7OOOOOOOO8OOOOOOOOO9OOOOOOOO1OOOOOOOOO2OOOOOOOOO3OOOOOOOO4OOOOOOOOO5OOOOOOOO6OOOOOOOOO7OOOOOOOO8OOOOOOOOO9OOOOOOOOO1OOOOOOOO2OOOOOOOOO3OOOOOOOO4OOOOOOOOO5OOOOOOOOO6OOOOOOOO7OOOOOOOOO8OOOOOOOO9OOOOOOOOO1OOOOOOOO2OOOOOOOOO3OOOOOOOOO4OOOOOOOO5OOOOOOOOO6OOOOOOOO7OOOOOOOOO8OOOOOOOOO9OOOOOOOO1OOOOOOOOO2OOOOOOOO3OOOOOOOOO4OOXXXXXXXXXXXXXXXXXXXXXXXXXXXXXOOOOOO8OOOOOOOOO9OOOOOOOO1OOOOOOOOO2OOOOOOOOO3OOOOOOOO4OOOOOOOOO5OOOOOOOO6OOOOOOOOOXXXXXXXXXXXXXXXXXXX9OOOOOOOOO1OOOOOOOO2OOOOOOOOO3OOOOOOOO4OXXXXXXXXXXXXXXXXXXXXXXXXXXXXXXXXXXXXXXXXXXXXXXXXXXXXXXXXXXXXXXXXXXXXXXXXXXXXXXXXXXXXXXXXXXXXXXXXXXXXXXXXXXXXXXXXXXXXXXXXXXXXXXXXXXXXXXXXXXXXXXXXXXXXXXXXXXXXXXXXXXXXXXXXXXXXXXXXXXXXXXXXXXXXXXXXXXXXXXXXXXXXXXXXXXXXXXXXXXXXXXXXXXXXXXXXXXXXXXXXXXXXXXXXXXXXXXXXXXXXXXXXXXXXXXXXXXXXXXXXXXXXXXXXXXXXXXXXXXXXXXXXXXXXXXXXXXXXXXXXXXXXXXXXXXXXXXXXXXXXXXXXXXXXXXXXXXXXXXXXXXXXXXXXXXXXXXXXXXXXXXXXXXXXXXXXXXXXXXXXXXXXXXXXXXXXXXXXXXXXXXXXXXXXXXXXXXXXXXXXXXXX
XSOOOOOOOO1OOOOOOOOO2OOOOOOOO3OOOOOOOOO4OOOOOXXXXXXXXXXXXXXXXXXXXXXXXXXXXXXXXXXXXXXXXXXXXXXXXXXXXXXXXXXXXXXXXXXXXXXXXXXXXXXXXXXXXXXXXXXXXXXXXXXXXXXXXXXXXXXXXXXXXXXXXXXXXXXXXXXXXXXOOOO1OOOOOOOO2OOOOOOOOO3OOOOOOOO4OOOOXXXXXXXXXXXXXXXXXXXXXXXXXXXXXXXXXXXXXXXXXXXXXXXXXXXXXXXXXXXXXXXXXXXXXXXXXXXXXXXXXXXXXXXXXXXXXXXXXXXXXXXXXXXXXXXXXXXXXXXX8OOOOOOOOO9OOOOOOOO1OOOOOOOOO2OOOOOOOO3OOOOOOOOO4OOOOOOOO5OOOOOOOOO6OOOOOOOOO7OOOOOOOXXXXXXXXXXXXXXXXXXXXXXXXXXXXXXXXXXXXXXXXXXXXXXXXXXXXXXXXXXXXXXXXXXXXXXOOOOOOOO7OOOOOOOO8OOOOOOOOO9OOOOOOOOO1OOOOOOOO2OXXXXXXXXXXXXXXXXO4OOOOOOOOO5OOOOOOOOO6OOOOOOOO7OOOOOOOOXXXXXXXXXXXXXXXXXXXXXXXXXXXXXXXXXXXXXXXXXXXXXXXXXXXXXXXXXXXXXXXXXXXXXXXXXXXXXXXXXXXXXXXXXXXXXXXXXXXXXXXXXXXXXXXXXXXXXXXXXXXXXXXXXXXXXXXXXXXXXXXXXXXXXXXXXXXXXXXXXXXXXXXXXXXXXXXXXXXXXXXXXXXXXXXXXXXXXXXXXXXXXXXXXXXXXXXXXXXXXXXXXXXXXXXXXXXXXXXXXXXXXXXXXXXXXXXXXXXXXXXXXXXXXXXXXXXXXXXXXXXOOOXXXXXXXXXXXXXXXXXXXXXXXXXXXXXXXXXXXXXXXXXXXXXXXXXXXXXXXXXXXXXXXXXXXXXXXXXXXXXXXXXXXXXXXXXXXXXXXXXXXXXXXXXXXXXXXXXXXXXXXXXX
XSOOOOOOOO1OOOOOOOOOXXXXXXXXXXXXXXXXXXXXXXXXXXXXXXXXXXXXXXXXXXXXXXXXXXXXXXXXXXXXXXXXXXXXXXXXXXXXXXXXXXXXXXXXXXXXOOOO3OOOOOOOO4OOOOOOOOO5OOOOOOOO6OOOOOOOOO7OOOOOOOO8OOOOOOOOO9OOOOOOOOO1OOOOOOOOXXXXXXXXXXXXXXXXXXXXXOOOOOOOO5OOOOOOOOO6OOOOOOOO7OOOOOOOOO8OOOOOOOO9OOOOOOOOO1OOOOOOOO2OOOOOOOOO3OOOOOOOOO4OOOOOOOO5OOOOOOOOO6OOOOOOOO7OOOOOOOOO8OOOOOOOOO9OOOOOOOO1OOOOOOOOO2OOOOOOOO3OOOOOOOOO4OOOOOXXXXXXXXXXXXXXXXXXXXXXXXXXXXXXXXXXXXXXXXXXXXXXXXXXXXXXXXXXXXXXXXXXXXXXXXXXXXXXXXXXXXXXXXXXXXXXXXXXXXXXXXXXXXXXXXXXXXXXXXXXXXXXXXXXXOOOOOOO1OOOOOOOO2OOOOOOOOO3OOOOOOOO4OOOOXXXXXXXXXXXXXXXXXXXXXXXXXXOOOOOOOO8OOOOOOOO9OOOOOOOOO1OOOOOOOO2OOOOOOOOO3OOOOOOOOO4OOOOOOOO5OOOOOOOOO6OOOOOOOO7OOOOOOOOO8OOOOOOOOO9OOOOOOOO1OOOOOOOOO2OOOOOOOO3OOOOOOOOO4OOOOOOOO5OOOOOOOOO6OOOOOOOOO7OOOOOOOO8OOOOOOOOO9OXXXXXXXXXXXXXXXXXXXXXXXXXXXXXXXXXXXXXXXXXXXXXXXXXXXXXXXXXXXXXXXXXXXXXXXXXXXXXXXXXXXXXXXXXXXXOO1OOOOOOOO2OOOOOOOOO3OOOOOOOO4OXXXXXXXXXXXXXXXXXXXXXXXXXXXXXXXXXXXXXXXXXXXXXXXXXXXXXXXXXXXXXXXXXXXXXXXXXXXXXXXXXXXXXXXXXXXXXXXXXXX
XSOOOOOOOO1OOOOOOOOO2OOOOOOOO3OOOOOOOOO4OOOOOOOO5OOOOOOOOO6OOOOOOOOO7OOOOOOOO8OOOOOOOOO9OOOOOOOO1OOOOOOOOO2OOOOOOOOO3OOOOOOOO4OOOOOOOOO5OOOOOOOO6OOOOOOOOO7OOOOOOOO8OOOOOOOOO9OOOOOOOOO1OOOOOOOO2OOOOOOOOO3OOOOOOOO4OOOOOOOOO5XXXXXXXXXXXXXXXXXXXXXXXXXXXXXXXXXXXXXXXXXXXXXXXXXXXXXXXXXXXXXXXXXXXXXXXXXXXXXXXXXXOOO5OOOOOOOOO6OOOOOOOO7OOOOOOOXXXXXXOOOOOO9OOOOOOOO1OOOOOXXXXXXXXXXXXXXXXXXXXXXXXXXXXXXXXXXXXXXXXXXXXXXXXXXXXXXXXXXXXXXXXXXXXXXXXXXXXXXXXXXOOXXXXXXXXXXXXXXXXXXXXXXXXXXXXOOOOOOO5OOOOOOOO6OOOOOOOOO7XXOOOOOO8OOOOOOOOO9OOOOOOOOO1OOOOOOOO2OOOOOOOOO3OOOOOOOO4OOOOOOOOO5OOOOOOOOO6OOOOOOOO7OOOOOOOOO8OOOOOOOO9OOOOOOOOO1OOOOOOOO2OOOOOOOOO3OOOOOOOOO4OOOOOOOO5OOOOOXXXXXXXXXXXXXXXXXXXXXXXXXXXXXXXXXXXXXXXXXXXXXXXXXXXXXXXXXXXXXXXXXXXXXXXXXXXXXXXXXXXXXXXXXXXXXXXXXXXX7OOOOOOOO8OOOOOOOOO9OOOOOOOO1OOOOOOOOO2OOOOOOOOO3OOOOOOOXXXXXXXXXOO5OOOOOOOXXXXXXXOXXXXXXXXXXXO8OOOOOOOOO9OOOOOOOOO1OOOOOOOO2OOOOOOOOO3OOOOOOOO4OOOOOOOOO5OXXXXXXXXXXXXXXXXXXXXXXXXXXXXXXXXXXXXXXXXXXXXXXXXXXXXXXXXXXXXXXXXXXXXXXXXXXXXXXXXXXXXXXXXX
XSOOOOOOOO1OOOOOOOXXXXXXXXXXXXXXXXXXXXXXXXXXXXXXXXXXXXXXXXXXXXXXXXXXXXXXXXXXXXXXXXXXXXXXXXXXXXXXXXXXXXXXXXXXXXXXXXXXXXXXXXXXXXXXXXXXXXXXXXXXXXXXXXXXXXXXXXXXXXXXXXXXXXXXXXXXXXXXXXXXXXXXXXXXXXXXXXXXXOOOOO3OOOOOOOO4OOOOOOOOO5OOOOOOOOO6OOOOOOOO7OOOOOOOOO8OOOOOOOO9OOOOOOOOO1OOOOOOOO2OOOOOOOOO3OOOOOOOOO4OOOOOOOO5OOOOOOOOO6OOOOOOOO7OOOOOOOOO8OOOOOOOOO9OOOOOOOO1OOOOOOOOO2OOOOOOOO3OOOOOOOOO4OOOOOOOO5OOOOOOOOO6OOOOOOOOO7OOOOOOOO8OOOOOOOOO9OOOOOOOO1OOOOOOOOO2OOOOOOOOO3OOOOOOOO4OOOOOOOOO5OOOOOOOO6OOOOOOOOO7OOOOOOOO8OOOOOOOOO9OOOXXXXXXXXXXXXXXXXXXXXXXXXXXXXXXXXXO4OOOOOOOOO5OOOOOOOOO6XXXXXXXXXXXXXXXXXXXXXXXXXXXXXXXXXXXXXXXXXXXXXX2OOOOOOOOO3OOOOOOOOO4OOOOOOOO5OOOOOOOOO6OOOOOOOO7OOOOOOOOO8OOOOOOOOO9OOOOOOOO1OOOOOOOOO2OOOOOOOO3OOOOOOOOO4OOOOXXXXXXXXXXXXXXXXXXXXXXXXXXXXXXOOO8OOOOOOOOO9OOOOOOOO1OOOOOOOOO2OOOOOOOOO3OOOOOOOO4OOOOOOOOO5OOOOOOOO6OOOOOOOOO7OOOOOOOO8OOOOOOOOO9OOOOOOOOO1OOOOOOOO2OOOOOOOOO3OOOOOOOO4OOOOOOOOO5OOOOOOOOO6OOOOOOOO7OOOOOOOOO8OOOOOOOO9OOOOOOOOO1OXXXXXXXXXXXXXXXXXXXXXXXXXXXXXXXXXXXXXXXXX
XSOOOOOOOO1OOOOOOOOO2OOOOOOOO3OOOOOOOOO4OOOOOOOO5OOOOOOOOO6OOOOOOOOO7OOOOOOOOXXXXXXXXXXXXXXXXXXXXXXXXXXXOO2OOOOOOOOO3OOOOOOOO4OOOOOOOOO5OOOOOOOO6OXXXXXXXXXXXXXXXXXXOOOOOOOOO9OOOOOOOOO1OOOOOOOO2OOOOOOOOOXXXXXXXXXXXXXXXXXXXXXXXXXXXXXXXXXXXXXXXXXXXXXXXXXXXXXXXXXXXXXXXXXXXXXXXXXXXXXXXXXXXXXXXXXXXXXXXXXXXXXXXXXXXXXXXXXXXXXXXXXXXXXXXXXXXXXXXXXXXXXXXXXXXXXXXXXXXXXXXXXXXXXXXXXXXXXXXXXXXXXXXXXXXXXXXXXXXXXXXXXXXXXXXXXXXXXXXXXXXXXXXXXXXXXXXXXXXXXXXXXXXXXXXXXXOOOOOOOOO3OOOOOOOO4OOOOOOOOO5OOOOOOOO6OOOOOOOOO7OOOOOOOO8OOOOOOOOO9OOOOOOOOO1OOOOOOOO2OOOOOOOOO3OOOOOOOO4OOOOOOOOXXXXXXXXXXXXXXXXXXXXXXXXXXXXXXXXXXXXXXXXXXXXXXXXXXXXXXXXXXXXXXXXXXXXXXXXXXXXXXXXXXXXXXXXXXXXXXXXXXXXXOXXXXXXXXXXXXXXXXXXXXXXXXXXXXXOOOO1OOOOOOOOO2OOOOOOOO3OOOOOOOOO4OOOOOOOO5OOOOOOOOO6OOOOOOOOO7OOOOOOOO8OOOOOOOOO9OOOOOOOO1OOOOOOOOO2OOOOOOOOO3OOOOOOOO4OOOOOOOOO5OOOOOOOO6OOOOOOOOO7OOOOOOOO8OOOOOOOOO9OOOOOOOOXXXXXXXXXXXXXXXXXXXXXXXXXXXXXXXXXXXXXXXXXXXXXXXXXXXXXXXXXXXXXXXXXXXXXXXXXXXXXXXOOOOOOOO1OOOOOOOOFOOOOOOOOOOOOXXXXXXXXXXXXXXXXXXXXX
XSOOOOOXXXXXXXXXXXXXXXXXXXXXXXXXXXXXXXXXXXXXXXXXXXXXXXXXOO6OOOOOOOOO7OOOOOOOO8OOOOOOOOO9OOOOOOOO1OOOOOOOOO2OOOOOOOOO3OOOOOOOO4OOOOOOOOO5OOOOOOOO6OOOOOOOOO7OOOOOOOO8OOOOOOOOO9OOOOOOXXXXXXXXXXXXXXXXXXXXXXXXXXXXXXXXXXXXXXXXXXXXXXXXXXXXXXXXXXXXXXXXXXXXXXXXXXXXXXXXXXXXXXXXXXXXXXXXXXXXXXXXXXXXXXXXXXXXXXXXXXXXXXXXXXXXXXXXXXXXXXXXXXXXXXXXXXXXXXXXXXXXXXXXXXXXXXXXXXXXXXXXXXXXXXXXXXXXXXXXXXXXXXXXXXXXXXXXXXXXXXXXXXXXXXXXXXXXXXXXXXXXXXXXXXXXXXXXXXXXXXXXXXXXXXXXXXXXXXXXXXXXXXOOOO4OOOOOOOOO5OOOOOOOO6OOOOOOOOO7OOOOOOOO8OOOOOOOOOXXXXXXXXXXXXXXXXXXXXXXXXXXXXXXXXXXXXXXXXXXXXXXXXXXXXXXXXXXXXXXXXXXXXXXXXXXXXXXXXXXXXXXXXXXXXXXXXXXXXXXXXXXXXXXXXXXXXXXXXXXXXXXXXXXXXXXXXXXXXXXXO6OOOOOOOXXXXXXXXXXXXXXXXXXXXXXXXXXXXXXXXXOOOOOOO2OOOOOOOO3OOOOXXXXXXXXXXXXXXXXXXXXXXXXXXXXXXXXXXXXXXOOOOO8OOOOOOOOO9OOOOOOOO1OOOOOOOOO2OOOOOXXXXXXOOOOOOO4OOOOOOOOO5OOOOOOOO6OOOOOOOOO7OOOOOXXXXXXXXXXXXXXXXXXXOOOO1OOOOOOOO2OOOOOOOOO3OOOOOOOO4OOOOOOOOOXXXXXXXXXXXXOOOOOOO7OOOOOOOOO8OOOOOOOO9OOOOOOOOO1OOOOOOOOFOOOOOOOOOOOOOOOOOOOOOOOOOOOOOOOOX
XSOOOOOOOO1OOOOOOOOO2OXXXXXOO3OOOOOOOOO4OOOOOOOO5OOOOOOOOO6OOOOOOOOO7OOOOOOOO8OOOOOOOOO9OOOOOOOO1OOOOOOOOO2OOOOOOOOO3OOOOOOOO4OOOOOOOOXXXXXXXXXXXXXXXXXXXXXXXXXXXXXXOOOOOOOOO9OOOOOOOOO1OOOOOOOO2OOOOOOOOO3OOOOOOOO4OOXXXXXXXXXXXXXXXXXXXXXXXXXXXXXXXXXXXXXXXXXXXXXXXXXXXXXXXXXXXXXXXXXOOOOOOOOO3OOOOOXXXXXXXXXXXXXXXXXXXXXXXXXXXXXXXXXXXXXXXXXXXXXXXXXXXXXXXXXXXXXXXXXOOOOOO2OOOOOOOO3OOOOOOOXXXXXXXXXXXXXXXXXXXXXXXXXXXXXXXXXXXXXXXXXXXXXXXXXXXXXXXXXXXXXXXXXXXXXXXXXXXXXXXXXXXXXXXXXXXXXXXXXX5OXXXOOOO6OOOOOOOOO7OOOOOOOO8OOOOOOOXXXXXXXXXXXXXXXXXXXXXXXXXXXXXXXXXXXXXXXXXXXXXXXXXXXXXXXXXXXXXXXXXXXXXXXXXXXXXXXXXXXXXXXXXXXXXXXXXXXXXXXXXXXXXXXXXXXXO3OOOOOOOOO4OOOOOOOO5OOOOOOOOO6OOOOOOOO7OOOOOOOOO8OOOOOOOOO9OOOOOOOO1OOOOOOOOO2OOOOOOOO3OOOOOOOOO4OOOOOOOO5OOOOOOOOO6OOOOOOOOO7OOOOOOOO8OOOOOOOOO9OOOOOOOO1OOOOOOOOO2OOXXXXXXXXXXOOOOOO4OOOOOOOOO5OOOOOOOO6OOOOOOOOO7OOOOOOOO8OOOOOOOOO9OOOOOOOOO1OOOOOOOO2OOOOOOOOO3OOOOOOOO4OOOOOOOOO5OOOOOOOOO6OOOOOOOO7OOOOOXXXXXXXXXXXXXXXXXXXXXXXXXXXXXXXXXXXXXXOOOOOOOOOOOOOOOOOOOOOOOOOOOX
XSOOOOOOOO1OOOOOOOOO2OOOOOOOO3OOOOOOOOO4OOOOOOOO5OOOOOOOOO6OOOOOOOOXXXXXXXXXXXXXXXXXXXXXXXXXXXXXXXXXXXXXXXXXXXXXXXXXXXXXXXXXXXXXXXXXOOO5OOOOOOOO6OOOOOOOOO7OOOOOOOO8OOOOOXXXXXXXXXXXXXXXXOOOOOOO2OOOOOOOOO3OOOOOOOO4OOOOOOOOO5OOOOOOOOO6OOOOOOOO7OOOOOOOOO8OOOOOOOO9OOOOOOOOO1OOOOOOOO2OOOOOOOOO3OOOOOOOOO4OOOOOOOO5OOOOOOOOO6OOOOOOOO7OOOOOOOOO8OOOOOOOOO9OOOOOOOO1OOOOOOOOO2OOOOOOOO3OOOOOOOOO4OOOOOOOO5OOOOOOOOO6OOOOOOOOO7OOOOOOOO8OOOOOOOOO9OOOOOOOO1OOOOOOOOO2OOOOOOOOO3OOOOOOOO4OOOOOOOOO5OOOOOOOO6OOOOOOOOO7OOOOOOOO8OOOOOOOOO9OOOOOOOOO1OOOOOOOO2OOOOOOOOO3OOOOOOOO4OOOOOOOOO5OOOOOOOOO6OOOOOOOO7OOOOOOOOO8OOOOOOOO9OOOOOOOOO1OOOOOOOO2OOOOOOOOO3OOOOOOOOO4XXXXXXXXXXXXXXXXXXXXXXXXXXXXXXXXXXXXXXXXXXXXXXXXXXXXXXXXXXXXXXXXXXXXXXXXXXXXXXXXXXXXXXXXXXXXXXXXXXXXXXXXXXXXXXXXXXXXXXXXXXXXXXXXXXXXXXXXXXXXXXXXXXXXXXXXXXXXXXXXXXXXXXXXXXX4OOOOOOOOO5OOOOOOOO6XXXXXXXXXXXXXXXXXXXXXXXXXXXXXXXXXXXXXXXXXXXXXXXXXXXXXXXXXXXXXXXXXXXXXXXXXXXXXXXXXXXXXXXXXXXXXXXXXXXXXXXXXXXXXXXXXXXXXXXXXXXXXXXXXXXXXXXXXXXXXXXXXXXXXXXXXXXXXXXXXXOOOOX
XXXXXXXXXXXXXXXXXXXXXXXXXXXXXXXXXXXXXXXXXXXXXXXXXXXXXXXXXXXXXXXXXXXXXXXXXXXXXXXXXXXXXXXXXXXXXXXXXXXXXXXXXXXXXXXXXXXXXXXXXXXXXXXXXXXXXXXXXXXXXXXXXXXXXXXXXXXXXXXXXXXXXXXXXXXXXXXXXXXXXXXXXXXXXXXXXXXXXXXXXXXXXXXXXXXXXXXXXXXXXXXXXXXXXXXXXXXXXXXXXXXXXXXXXXXXXXXXXXXXXXXXXXXXXXXXXXXXXXXXXXXXXXXXXXXXXXXXXXXXXXXXXXXXXXXXXXXXXXXXXXXXXXXXXXXXXXXXXXXXXXXXXXXXXXXXXXXXXXXXXXXXXXXXXXXXXXXXXXXXXXXXXXXXXXXXXXXXXXXXXXXXXXXXXXXXXXXXXXXXXXXXXXXXXXXXXXXXXXXXXXXXXXXXXXXXXXXXXXXXXXXXXXXXXXXXXXXXXXXXXXXXXXXXXXXXXXXXXXXXXXXXXXXXXXXXXXXXXXXXXXXXXXXXXXXXXXXXXXXXXXXXXXXXXXXXXXXXXXXXXXXXXXXXXXXXXXXXXXXXXXXXXXXXXXXXXXXXXXXXXXXXXXXXXXXXXXXXXXXXXXXXXXXXXXXXXXXXXXXXXXXXXXXXXXXXXXXXXXXXXXXXXXXXXXXXXXXXXXXXXXXXXXXXXXXXXXXXXXXXXXXXXXXXXXXXXXXXXXXXXXXXXXXXXXXXXXXXXXXXXXXXXXXXXXXXXXXXXXXXXXXXXXXXXXXXXXXXXXXXXXXXXXXXXXXXXXXXXXXXXXXXXXXXXXXXXXXXXXXXXXXXXXXXXXXXXXXXXXXXXXXXXXXXXXXXXXXXXXXXXXXXXXXXXXXXXXXXXXXXXXXXXXXXXXXXXXXXXXXXXXXXXXXXXXXXXXXXXXXXXXXXXXXXXXXXXXXXXXXXXXXXXXXXXXXXXXXXXXXXXXXXXXXXXXXXXXXXXXXXXXXXXXXXXXXXXXXXXXXXXX
