XXYYZZZZZZYXXXXYZZZYYYXYYZZZZYYYYYZZZZZYYYYZZZZZZZYYYYXXXXXXXXXXXXXXYYZZZZZZZZZZYYYYYYYYYYZZZZZZZZZYYYYYYYYYYYYYYYYYYYYYYYYYYYYYYYYYXXXXXXXXXYYYYYYYYYYYYZZZZZYXXXYYZZZZZZZYXXXXYYYZZYYYYXXXXXXXXXXXXXXYXX
XSOOOOOOOOOOOOOOOOO1OOOOOOOOOOOOOOOOOO2OOOOOOOOOOOOOOOOO3OOOOOOOOOOOOOOOOOO4OOOOOOOOYYYYYYYZZZZZZZZYYYYYYYYYYYYYYYYYYYYYYYYYYYYYYYYYYXXXXXXXYYYYYYYYYYYYYZZZZZYXXXXYZZZZZZZYXXXXYYYYZYYYYXXXXXXXXXXXXYYYYY
XSOOOOOOOOOOOOOOOOO1OOOOOOOOOOOOOOOOOO2OOOOOOOOOOOOOOOOO3OOOOOOOOOOOOOOOOOO4OOOOOOOOOOOOOOOOO5OOOOOOOOOOOOOYYYYYYYYYYYYYYYYYYYYYYYYYYYYYXXXYYYYYYYYYYYYYYYZZZYYXXXXYZZZZZZYYXXXXYYYOOOOOOOFOOOOOOOOOOOOOOY
XSOOOOOOOOOOXXXXYZZ1OOOOOOOOOOOXXYYYYYYYYYYZZZZZZYYYYYYYYYYYYYXXXXXYYZZZZZZZOOOOOOOOOOOOOOOOO5OOOOOOOOOOOOOOOOOO6OOOOOOOOOOOOOOOOOO7OOOOOOOOOOOOOOOOO8OOOOOOOOOOOOOOOOOO9OOOOOOOOOOOOOOOOOFOOOOOO1O123334Y
XSOOOOOOOOOOOOOOOOO1OOOOOOOOOOOOOOOOOO2OOOOOOOOOOOOOOOOO3OOOOOOOOOOOOOOOOOO4OOOOOOOOOOOOOOOOO5OOOOOOOOOOOOOOOOOO6OOOOOOOOOOOOOOOOOO7OOOOOOOOOOOOOOOOO8OOOOOOOOOOOOOOOOOO9OOOOOOOOOOOOOOOOOFOOOOOO1O12O3O4Z
XSOOOOOOOOOOOOOOOOO1OOOOOOOOOOOOOOOOOO2OOOOOOOOOOOOOOOOO3OOOOOOOOOOOOYYYYYYZZZZZYYYYYYYYYYYYYYYYZZZZYYYYYYYYYYYYYYYYYYYYYYYYYYYYYYYZZZZZZZZZYYYYYYYYYYZZZZZZZYYXXXXXYZZZZZYXXXXYYZZYYYYYYYYYZZZZZ111223Z4Z
XXYYYZZZYYXXXXXXZZZZZZZZZZZZYYXXXXXYYYYYYYZZZZZZYYYYYYYZZZZZZYXXXXXXYYYYYYYZZZZZYYYYYYYYYYXXYYYYZZZZZYYYYYYYYYYYYYYYYYYYYYYYYYYYZZZZZZZZZZZZYYYYXYYYYZZZZZZZZZYXXXXXYZZZZZYXXXXYZZZYYYYYYYYZZZZZZZZZZZZZZZ
