ZZZYYYYYZZZZZZZZYYYXXXXXXXXXXYYYXXXXXXYYYYYZZZZZZZZZYYYXXXXXXXYYYYYYYYZZYYYYYYXXXXXXXXXXYYYYYYYYYYYYYYZZZZZZZZYYYYYYYYYYYYYYYYYXXXXXXXYYYYYYYYYYYYYYYYYYYYYYYYYYYYYYYYYYYYYYYYYYYYYYYYYYYYYYYYYYYYYYYYYYYY
ZS1O2O3O4O5O6O78O9O1O2O3O4O56O7O8O9O1O2O34O5O6O7O8O9O12O3O4O5O6O7O89O1O2OZYYYYXX7O8O9O1O2O3O45O6O7O8O9O1O2O34O5O6O7O8O9O12O3O4O5O6O7O89O1O2O3O4O5O67O8O9O1O2O3O45O6O7O8O9O1O23O4O5O6O7O8O9FOOOOOOOOOOOOOOY
ZS1O2O3O4O5O6O78O9O1O2O3O4O56O7O8O9O1O2O34O5O6O7O8O9O12O3O4O5O6O7O89O1O2O3O4O5O67O8O9O1O2O3O45O6O7O8O9O1O2O34O5O6O7O8O9O12O3O4O5O6O7O89O1O2O3O4O5O67O8O9O1O2O3O45O6O7O8O9O1O23O4O5O6O7O8O9FOOOYYYYYYYYYYZZ
ZS1O2O3O4O5O6O7YYXX1O2O3O4O56O7O8O9O1O2O34O5O6OZZZZYYXXXXXYYYYYYZZZZZZZZZZZ4O5O67O8O9XXXXXXXXXX6O7O8O9O1O2O34O5O6O7O8O9O12O3O4O5O6O7O89O1O2O3O4O5ZZZZYYYYYXXXXXXXXYYYYYYYYXXXXXXXXXXXXXYYYYYYYYYY1Y123334Z
ZS1O2O3O4O5O6O78O9O1O2O3O4O56O7O8O9O1O2O34ZZZZZZZZZYYXXXXYYYYYYYZZZZZZZZZZZZYYYXXXXXXXXXXXXXXXXXXXXXYYYZZZZZYYYXXXXXYYYYYYYYYYXXXXXXXXXXXXYYYYYZZZZZZYYYYYXXXXXXXXYYYYYYYYXXXXXXXXXXXXXYYYYYYYYYY1Y12Z3Z4Z
ZS1O2O3O4O5O6O78O9O1XXXXXXXXXXXXXXXXXXXYYZZZZZZZZZZYYXXXYYYYYYYZZZZZZZZZZZZZYYYXXXXXXXXXXXXXXXXXXXXXYYYZZZZZYYYXXXXXYYYYYYYYYYXXXXXXXXXXXXYYYYYYZZZZZYYYYYXXXXXXXYYYYYYYYYXXXXXXXXXXXXXYYYYYYYYYY111223Z4Z
ZZZZZYYYYYYYYYYYXXXXXXXXXXXXXXXXXXXXXXXYYZZZZZZZZZZZYXXYYYYYYYYYZZZZZZZZZZZZYYYYXXXXXXXXXXXXXXXXXXXXYYYZZZZZYYYXXXXXYYYYYYYYYXXXXXXXXXXXXXYYYYYYZZZZZYYYYYYXXXXXXYYYYYYYYYYXXXXXXXXXXXXYYYYYYYYYYYYYZZZZZZ
