YYYYYYYYYXXXXXXXXYYYYYYZZZZZZZZZZZYYYYYYYYYYYYYYYYYYYYYYYYYYYYYXXXXXXXXXXXXYYZZZZZZZZZZZYYYYYYYYYYYYYYYYYYYYYYYYYYYYYYYYYYYYYYYYYYXXXXXXXXXXXXXYYZZZZZZZZZZYYYYYYYYYYYYYYYYXXXXXXXXXXXXYYYYYYYYYYYYYYYYYYY
ZSOOOOOOOOOOOOOOOOO1OOOOOOOOOOOOOOOOOO2OOOOOOOOOOOOOOOOO3OOOOOOOOOOOOOOOOOO4OOOOOOOOOOOOOOOOO5OOOOOOOOOOOOOOOOOO6OOOOOOOOOOOOOOOOOO7OOOOOOOOOOOOOOOOO8OOOOOOOOOOOOOOOOOO9OOOOOOOOOOOOOOOOOFOOOOOOOOOOOOOOY
YSOOOOOOOOOOOOOOOOO1OOOOOOOOOOOOOOOOOO2OOOOOOOOOOOOOOOOOYYYYYYYYXXXXXXXXXXXYYZZZZZZZZZZZZYYYYYYYYYYYYYYYYYYYYYYYYYYYYYYYYYYYYYYYYYYXXXXXXXXXXXXYYZZZZZZZZZZZYYYYYYYYYYYYYYYXXXXXXXXXXXXYYYYYYYYYYYYYYYYYYY
YSOOOOOOOOOOOOOOOOO1OOOOOOOOOOOOOOOOOO2OOOOOOOOOOOOOOOOO3OOOOOOOOOOOOOOOOOO4OZZZZZOOOOOOOOOOO5OOOOOOOOOOOOOOOOOO6OOOOOOOOOOOOOOOOOO7OOOOOOOOOOOOOOOOO8OOOOOOOOOOOOOOOOOO9OOOOOOOOOOOOOOOOOFOOOOOOOOOOOOOOX
YSOOOOOOOOOOOOOOOOO1OOOOOOOOOOOOOOOOOO2OOOOOOOOOOOOOOOOO3OOOOOOOOOOOOOOOOOO4OOOOOOOOOOOOOOOOO5OOOOOOOOOOOOOOOOOO6OOOOOOOOOOOOOOOOOO7OOOOOOOOOOOOOOOOO8OOOOOOOOOOOOOOOOOO9OOOOOOOOOOOOOOOOOFOOOOOOOOOOOOOOX
XSOOOOOOOOOOOOOOOOO1OOOOOOOOOOOOOOOOOO2OOOOOOOOOOOOOOOOO3OOOOOOOOOOOOOOOOOO4OOOOOOOOOOOOOOOOO5OOOOOOOOOOOOOOOOOO6OOOOOOOOOOOOOOOOOO7OOOOOOOOOOOOOOOOO8OOOOOOOOOOOOOOOOOO9OOOOOOOOOOOOOOOOOFOOOOOOOOOOOOOOX
XSOOOOOOOOOOOOOOOOO1OOOOOOOOOOOOOOYYYYYYYYYYYYYYYYYYYZZZZZZZYYYYYXXXXXXXXXXXYYZZZZZZZZZZZYYYYYYXXXXXXYYYYYYYOOOO6OOOOOOOOOOOOOOOOOO7OOOOOXXXXXXXYYYYZZZZZZZZZZZZZZZZZYYYYYYXXXXXXXXXXXXXXXXXXXXXXXXXXXXXXX
XSOOOOOOOOOOOOOOOOO1OOOOOOOOOOOOOOOOOO2OOOOOOOOOOOOOOOOO3OOOOOOOOOOOOOOOOOO4OOOOOOOOOOOOOOOOO5OOOOOOOOOOOOOOOOOO6OOOOOOOOOOOOOOOOOO7OOOOOOOOOOOOOOOOO8OOOOOOOOOOOOOOOOOO9OOOOOOOOOOOOOOOOOFOOOOOOOOOOOOOOX
XSOOOOOOOOOOOOOOOOO1OOOOOOOOOOOOOOOOOO2OOOOOOOOOOOOOOOOO3OOOOOOOOOOOOOOOOOO4OOOOOOOOOOOOOOOOO5OOOOXXXXYYYYYYYYYYYYYYYYYYZZZZZZZZZYYYXXXXXXXXXXXXXYYYYYZZZZZZZZZZZZZZZYYYYYYOOOOOOOOOOOOOOOFOOOOOOOOOOOOOOX
XSOOOOOOOOOOOOOOOOO1OOOOOOOOOOOOOOOOOO2OOOOOOOOOOOOOOOOO3OOOOOOOOOOOOOOOOOO4OOOOOOOOOOOOOOOOO5OOOOOOOOOOOOOOOOOO6OOOOOOOOOOOOOOOOOO7OOOOOOOOOOOOOOOOO8OOOOOOOOOOOOOOOOOO9OOOOOOOOOOOOOOOOOFOOOOOOOOOOOOOOX
XSOOOOOYYYYXXXXXXXXXXXXXXXXXXXXXXXYYYXXXXXYYYYYYYYYZZZZZZZZZZZYYYXXXXXXXXXXXYYZZZZZZZZZZZZYYYXXXXXXXXXYYYYYYYYYYYYYYYYYZZZZZZZZZZYYYYXXXXXXXXXXXXXYYYYYYZZZZZZZZZZZYYYYYYYYYYXXXXXXXXXXXXXXXXXXXXXXXXXXXXX
XSOOOOOOOOOOOOOOOOO1OOOOOOOOOOOOOOOOOO2OOOOOOOOOOOOOOOOO3OOOOOOOOOOOOOOOOOO4OOOOOOOOOOOOOOOOO5OOOOOOOOOOOOOOOOOO6OOOOOOOOOOOOOOOOOO7OOOOOOOOOOOOOOOOO8OOOOOOOOOOOOOOOOOO9OOOOOOOOOOOOOOOOOFOOOOOOOOOOOOOOX
XSOOOOOOOOOOOOOOOOO1OOXXXXXXXXXXXYYYYXXXXXXXYYYYYYYZZZZZZZZZZYYYYXXXXXXXXXXYYYZZZZZZZZZZZYYYXXXXXXXXXXYYYYYYYYYYYYYYYYZZZZZZZZZZZYYYYYYXXXXXXXXXOOOOO8OOOOOOOOOOOOOOOOOO9OOOOOOOOOOOOOOOOOFOOOOOOOOOOOOOOX
XSOOOOOOOOOOOOOOOOO1OOOOOOOOOOOOOOOOOO2OOOOOOOOOOOOOOOOO3OOOOOOOOOOOOOOOOXXYYYZZZZZZZZZZZYYXXXXXXXXXXXYYYYYYYYYYYYYYYYZZZZZZZZZZZYYYYYYYYXXXXXXYXXXXXXXYYYYYZZZYYYYYYYYYYYYYYYYYYYYYYYXXXYYYYYYYY1X123334X
XSOOOOOOOOOOOOOOOOO1OOOOOOOOOOOOOOOOOO2OOOOOOOOOOOOOOOOO3OOOOOOOOOOOOOOOOOO4OOOOOOOOOOOOOOOOO5OOOOOOOOOOOOOOOOOO6OOOOOOOOOOOOOOOOOO7OOOOOOOOOOOOOOOOO8OOOOOOOOOOOOOOOOOO9OOOOOOOOOOOOOOOOOFOOOOOO1O12O3O4Y
XSOOOOOOOOOOOOOOOOO1OOOOOOOOOOOOOOOOOO2OOOOOOOOOOOOOOOOO3OOOOOOOOOOOOOOOOOO4OOOOOOOOOOOOOOOOO5OOOOOOOOOOOOOOOOOO6OOOOOOOOOOOOOOOOOO7OOOOOOOOOOOOOOOOO8OOOOOOOOOOOOOOOOOO9OOOOOOOOOOOOOOOOOFOOOOOO111223O4Y
XXXXXXYYYYYYYYYYYYYYYYYYYYYYYYYYYYYYYYYYXXXXXXXYYYYYYZZZZZYYYYYYXXXXXXXXXXYYYZZZZZZZZZZZYYXXXXXXXXXXXXYYYYYYYYYYYYYYYYZZZZZZZZZZZYYYYYYYYYYYYYYYYXXXXXXXXXXXYYYXXXXXXXXXYYYYYYYZZZZZZYYYYYYZZZZZZZYYYYYYYY
