YYYZZZZYYYYYYYYYYYYYYYYYYYYYYYYYYXXXYYYZZZZZYYXXXXXXYYYYZYYYYYYYYYYYYYZZYYYYXXXXXXYYYYYYYYYY
YYZZZZZZYYYYYYYYYYYYYYYYYYYYYYYYYYYYYYZZZZZZZYXXXXXXYYYYYYYYYYYYYYYYYYYYYYYXXXXXXXYYYYYYYYYY
YZZZOSSOYYYYYYYXXXYYYYYZZZZYYYYYYYYYYYZZZZZZZYYXXXXXYYYYYYYYYYYYYYYYYYYYYYYXXXXXXXYYYYYYYYYZ
YZZOSSOOYYYYYYXXXXXYYYYZZZZZZYYYYYYYYZZZZZZZZYYXXXXXYYYYYYYYXYYYYYYYYYYYYYYXXXXXXXXYYYYYYYZZ
YZOSSOOOYYYYYYXXXXXYYYZZZZZZZYYYYYYYZZZZZZZZZYYXXXXXYYYYYYYYXYYYYYYYYYYYYYYXXXXXXXXYYYYYYZZZ
YZSSOOOOYYYYYXXXXXXXYYZZZZZZZZYYYYYZZZZZZZZZZYYXXXXXYYYYYYYXXYYYYYYYYYYYYYYXXXXXXXXXYYYYYZZZ
YZOOOOOOYYYYYXXXXXXXYYZZZZZZZZYYYYZZZZZZZZZZZZYXXXXXYYYYYYYXXYYYYYYYYYYYYYYXXXXXXXXXYYYYYZZZ
YZOOOOOOOYYYYXXXXXXXYYOOOZZZZZYYYZZZZZZZZZZZZZYXXXXXYYYYYYYXXYYYYYYYYYXXXXYXXXXXXXXXYYYYYZZZ
YZZZZZZOOOYYYXXXXXXXXOOOOZZZZZYYYZZZZZZZZZZZZYYXXXXXYYYYYYYXXYYYYYYYYXXXXXYXXXXXXXXXYYYYYZZZ
YZZZZZZZOOOYYYXXXXXXOOOOOZZZZZYYYZZZZZZZZZZZZYYXXXXXYYYYYYYXXYYZZYYYYXXXXXYXXXXXXXXYYYYYYZZZ
YZZZZZZZYOOOYYXXXXXO11OOZZZZZZYYYZZZZZZZZZZZZYYXXXXXYYYYYYYXXYYZZZYYYXXXXXYYXXXXXXXYYYYYYYZZ
YZZZZZZZYYOOOYYXXXOO111ZZZZZZZYYYZZZZZZZZZZYYYYXXXXXYYYYYYYYYYZZZZYYYXXXXXYYXXXXXXYYYYYYYYZZ
YYZZZZZZYYYOOOYYXOOOO1YYZZZZZZYYYYZZZZYYYYYYYYYXXXXXYYYYYYYYYYZZZZZYYXXXXXYYYYYXYYYYYYYYYYZZ
XYZZZZZZYYYYOOOYYOOOOXXYYZZZOOOYYYYYYYYYYYYYYYXXXXXXYYYYYYYYYZZZZZZYYXXXXXYYYYYYYYYYYYYYYYYZ
XYZZZZZZYYYYYOOOYOOOXXXYYYZOOOOYYYYYYYYYYYYYYYXXXXXXYYYYYYYYYZZZZZZYYXXXXYYYYYYYYYYYYYYYYYYZ
XYZZZZZZZYYYYYOOOOOOXXXYYYOOOOOXYYYYYXXXXXXXXXXXXXXXYYYYYYYYYYZZZZZYXXXXXYYZYYYYYYYYYYYYYXYY
XYZZZZZZZZZZZZZOOOOXXXXXYOOOOOXXXXXXXXXXXXXXXXXXXXXYYZYYYYYXXYZZZZYYXXXXYYZZZZZZZZZYYYYYXXXY
XYYZZZZZZZZZZZZZOOOOXXXXOOOOOXXXOOOXXXXXXXXXXXXXXXXYZZZYYYYXXYYZZZYYXXXXYYZZZZZZZZZYYYYYXXXY
XYYZZZZZZZZZZZZZZOOOOXOOOOOOXXXOOOOXXXXXXXXXXXXXXXXYZZZYYYYXXYYZZZYYXXXXYYZZZZZZZZZZYYYXXXXY
XYYZZZZZZZZZZZZZZYOOOOOOOOOXXXOOOOOXXXXXXXXXXXXXXXXYZZZYYYYXXYYZZZYYXXXXYYZZZZZZZZZZYYYXXXXY
XYYZZZZZZZZZZZZZZZYOOOOOOOXXXOOOOOXXXXXXXXXXXXXXXXXYZZZYYYYXXYYZZZYYXXXXYYZZZZZZZZZZYYYXXXXY
XYYZZZZZZZZZZZZZZZYYOOOXXXXXOOOOOXXXXXXXXXXXXXXXXXXYZZZYYYYXXYYZZYYYXXXXYYZZZZZZZZZZYYYXXXXY
XYYZZZZZZZZZZZZZZZZYYOOOXXXOOOOOXXXXXXXOOOXXXXXXXXXYZZZYYYYXXYYZZYYYXXXXYYZZZZZZZZZZYYYXXXXY
XYYZZZZZZZZZZZZZZZZZYYOOOXOOOOOXXXXXXXXOOOOXXXXXXXYYZZZYYYYXXYYZZZYYXXXXXYZZZZZZZZZZYYYYXXXY
XYYZZZZZZZZZZZZZZZZZZYYOOOOOOOXXXXXXXXXOOOOOXXXXXXYYZZZYYYYXXYYZZZYYXXXXXYZZZZZYYYZYYYYYXXXY
XYYYZZZZZYYYYYYYZZZZZZYYOOOOOXXXXXXXXXXYOOO33XXXXXXYYZYYYYYYYYZZZZYYXXXXXYYZYYYYYYYYYYYYYXYY
XYYYZZZZYYYYYYYYYZZZZZYYYYOO2OYXXXXXXXYYOO333OXXXXXYYYYYYYYYYYZZZZYYXXXXXXYYYYYYYYYYYYYYYYYY
XYYYYYYYYYYYYYYYYZZZZZZYYYO222OYXXXXXYYOOOO3OOOYXXXYYYYYYYYYYZZZZZZYXXXXXXYYYYYYYYYYYYYYYYYY
XYYYYYYYYYYYYXXXYYZZZZZYYYY22OOOXXXXYYOOOOOOOOOYYYXXYYYYYYYYYZZZZZZYXXXXXXXYXXXXXYYYYYYYYYZZ
YYYYYYYYXXXXXXXXXYYZZZYYYYYYOOOOYYYYYOOOOOZZOOOYYYYXXXXXYYYYYZZZZZYYXXXXXXXXXXXXXXYYYYYZZZZZ
YYYYYYXXXXXXXXXXXYYYYYYYYYYYYOOOYYYYOOOOOZZZZZZYYYYXXXXXXYYYYZZZZZYYYXXXXXXXXXXXXXXYYYZZZZZZ
YYYYYXXXXXXXXXXXXXYYYYYYYYYYYYOOOYYOOOOOZZZZZZZZYYYXXXXXXXYYYZZZZZYYYXXXXXXXXXXXXXXYYYZZZZZZ
YYYYXXXXXXXXXXXXXXXYYYYYYYYYYYYOOOOOOOOZZZZZZZZZOOOXXXXXXXYYZZZZZZYYYXXXXXXXXXXXXXXYYYZZZZZZ
YYYXXXXXXXXXXXXXXXXXYYYYYYYYYYYYOOOOOOZZZZZZZZZOOOOXXXXXXXYYZZZZZZYYYYYXXXXXXXXXXXXYYZZZZZZZ
YYYXXXXXXXXXXXXXXXXXYYYYYYYYYYYYYOOOOZZZZZZZZZOOOOOYXXXXXXXYZZZZZZYYYYYYXXXXXXXXXXXYYZZZZZZZ
YYYXXXXXXXXXXXXXXXXXXYYYYYYYYYYYYYOOOZZZZZZZZO4OOOYYXXXXXXXYZZZZZYYYYYYYYXXXXXXXXXXYYZZZZZZZ
YYYXXXXXXXXXXXXXXXXXXYYYYYYYYYYYYYZOOOZZZZZZO444OZYYOOOXXXXYYZZZYYYYYYYYYYXXXXXXXXXYYZZZZZZZ
YYXXXXXXXXYYYYXXXXXXXXYYYYYYYYYYYYZZOOOZZZZOOO44ZZYOOOOXXXXYYYYYYYYYYYZYYYYXXXXXXXXYYZZZZZZY
ZYXXXXXXXYYYYYYXXXXXXXYYYYYYYYYYYYYZZOOOZZOOOOOZZZOOOOOXXXXYYYYYYYYYYZZZZYYXXXXXXXYYYZZZZZZY
ZYXXXXXXXYYYYYYYXXXXXXYYYYYYYYYYYYYYYYOOOOOOOOZZZOOOOOOXXXXYYYYYYYYYYZZZZZYXXXXXXXYYYZZZZZYY
ZYXXXXXXYYZZZZYYYXXXXXXYYYYYYYYYYYYYYYYOOOOOOYZZOOOOOOOXXXXXYYYYYYYYZZZZZZYYXXXXXXYYZZZZYYYY
ZYXXXXXXYYZZZZZZYYXXXXXYYYYYYYYYYYYYYYYYOOOOYYYOOOOOYOOXXXXXYYYYYYYYYZZZZZYYXXXXXXYYZZZZYYYX
ZYXXXXXXYYZZZZZZYYYXXXXYYYYYYYYYYYYYYYXYYOOOYYOOOOOZYOOXXXXYYYYYYYYYYZZZZZYYXXXXXXYYZZZZYYYX
ZYYXXXXXYYZZZZZZZYYYXXXXXXXYYYYYYYYYYXXXXXOOOOOOOOZYYOOOOO66OOYYYYXXYZZZZZYXXXXXXYYZZZZZYYYX
ZZYXXXXXYZZZZZZZZZYYXXXXXXXXYYYYYYYYYXXXXXXOOOOOOZYYYOOOOO66OOYYYYXXYYZZZYYXXXXXXYYZZZZZYYYY
ZZYXXXXXYZZZZZZZZZYYYXXXXXXXXYYYYYYYYXXXXXXXXOOOYYYYYXXXXO66OOYYYYXXYYYZZYYXXXXXXYYZZZZZYYYY
ZZYYXXXXYZZZZZZZZZYYYXXXXXXXXYYYYYYYYXXXXXXXXXYYYYYYYYXXOOOOOZYYYXXXXYYYYYYXXXXXXYYZZZZZZYYY
ZZYYXXXYYZZZZZZZZZZYYYXXXXXXXYYYYYYYYXXXXXXXXXYYYYYYYYXO5OOOZZYYYXXXXYYYYYYXXXXXXYYZZZZZZYYY
ZZYYXXXYYZZZZZZZZZZYYYXXXXXXXXYYYYYYYXXXXXXXXXYYYYYYYYOO55OYZZYYYXXXXYYYYYYXXXXXXYYZZZZZZYYY
YZYYYXXYYZZZZZZZZZZYYYXXXXXXXXYYZZZYYXXXXXXXXXXYYYYYYOOO55YZZZYYYXXXXYYYYYYXXXXXXYYZZZZZZYYY
YZYYYXYYYYZZZZZZZZZYYYYXXXXXXXYYZZZYYYXXXXXXXXXYYYYYOOOOOYYYZYYYOOOOOYYYYYYXXXXXXYYZZZZZZYYY
YYYYYYYYYYZZZZZZZZZYYYYXXXXXXXYYZZZZYYXXXYYYYYYYYYYYOOOOYYYYZYOOOOOOOOYYYYYXXXXXXYYZZZZZZYYY
YYYYYYYYYYZZZZZZZZZZYYYYXXXXXXYYZZZZYYXYYYYYYYYYYYYYOOOYYYYYOOOOOOOOOOYYYYYXXXXXXXYZZZZZZYYY
YYYYYYYYYYZZZZZZYZZYYYYYXXXXXXYYZZZZZYYYYYYYYYYYYYYYYOOYYYOO77OOOOYOOOYYYYYYXXXXXXYZZZZZZYYY
XYYYYXYYYYYZZZYYYYYYYYYYXXXXXXYYZZZZZZYYYYYYYYYYYYYYYOOOOOOO77OOYYOOOOYYYYYYXXXXXXYZZZZZZYYY
XYYYXXXYYYYYYYYYYYYYYZYYYXXXXXYYZZZZZYYYYYYYYYYYYYYYYYOOOOOO77OOYYOOOOYYOOOYXXXXXXYYZZZYYYXX
XYYYXXXXYYYYYYYXXYYYZZZZYXXXXXXYZZZZZYYYYYYYYYYYYYYYZZZYOOOOYYYOOOOOOZZZO88OYXXXXXYYYYYYYXXX
YYYYXXXXXYYYYXXXXYYYZZZZYXXXXXXYYZZZZYYYYYYYYXYYYYYZZZZZZYYYYYYYOOOOOZZZ88OOOXXXXXYYYYYYXXXX
YYYYXXXXXXXXXXXXXXYYZZZZYYXXXXXYYZZZZYYYYYYYYXYYYYZZZZZZZYYYYYYZOOOOZZZZZOOOOOXXXXYYYYYXXXXX
YYYYXXXXXXXXXXXXXXYYZZZZYYXXXXXYYZZZZYYYYYYYXXYYYYZZZZZZZYYYYYZZOOOOZZZZZOOOOOOXXXYYYYXXXXXX
YYYYXXXXXXXXXXXXXXYYZZZZYYXXXXXYYYZZYYYYYYYYXXYYYZZZZZZZZYYYYYZOOOOZZZZZOOOOOOOOXXYYXXXXXXXX
YYYYXXXXXXXXXXXXXXYYZZZZYYXXXXXYYYYYYYYYYYYYXXYYYZZZZZZZZYYYYZZOOOOZZZZOOOOOOOOOYXXXXXXXXXXX
YYYYXXXXXXXXXXXXXXYZZZZZYYXXXXXYYYYYYYYYYYYYXXYYYZZZZZZZYYYYYZZOOOZZZZOOOOOZZOOOYYXXXXXXXXXX
YYYYYXXXXXXXXXXXXYYZZZZZYXXXXXXYYYYYYYYYYYYYXXYYZZZZZZZZYYYYYZZOOOZZZOOOOOZZZYYYYYYXXXXXXXXX
YYYYYYXXXXXXXXXXXYYZZZZZYXXXXXXYYYYYYYYYYYYYYXYYZZZZZZZYYYYYYZZZOOZZOOOOOZZZZYYYOOOOXXXXXXXX
YYYYYYYYYXXXXXXXXYYZZZZZYXXXXXXYYYYYYYYYYYYYYYYYZZZZZZYYYYYYYZZZOOOOOOOOYYZZZYYOOOOOOXXXXXXY
YYYYYYYYYXXXXXXXYYZZZZZYYXXXXXXYYYYYYYYYYYYYYYYYZZZZZYYYYYYYYZZZZOOOOOOYYYYYYYOOOOOOOOXXXXYY
YYYYYYYYYYXXXXXXYYZZZZZYXXXXXXYYYYYYYYYYYYYYYYYZZZZZYYYYXXYYYZZZZZOOOOYYYYYYYOOOOOOOOOOXXYYY
YYYYYYYYYYXXXXXYYZZZZZZYXXXXXXYYYYYYYYYYYYYYYYYZZZZYYYYXXXXYYZZZZZZOOOXXXXYY99OOOYYOOOOOYYYZ
XXYYYYYYYYYYYYYYZZZZZZYYXXXXXXXYYYYYZZZYYYYYYYYYZZZYYYYXXXYYYYZZZZZYOOOXXXXO999OOYYYOOOOYYYZ
XXXYYYYZZZYYYYYZZZZZZZYXXXXXXXXYYYYZZZZZZZYYYYYYZZZYYYYYYYYYYYZZZZZYYOOOXXOOO9OOOYYYYOOOYYYY
XXXXYYYZZZZYYYYZZZZZZZYXXXXXXXXYYYZZZZZZZZYYYYYYYZYYYYYYYYYYYYZZZZZYYYOOOOOOOOOOOYYYYYYYYYYY
XXXXYYYZZZZYYYZZZZZZZZYXXXXXXXXYYYZZZZZZZZZYYYYYYYYYYYYYYYYYYYZZZZZZYYXOOOOOOXXXYYYYYYYYYYYY
XXXXYYYZZZZZZZZZZZZZZZYXXXXXXXXYYYZZZZZZZZZYYYYYYYYYYYYYYYYYYYZZZZZZYYXXOOOOOXXXXYYYYYYYYYYY
XXXXYYYZZZZZZZZZZZZZZZYXXXXXXXXYYYZZZZZZZZZYYYYYYYYYYYYYYYYYYYZZZZZZYYYXXOOOOOXXXYYYYYYYYYYY
XXXXYYYZZZZZZZZZZZZZZZYXXXXXXXXYYYZZZZZZZZZYYYYYYYYYYYYYYYYYYYYZZZZZYYYXXXOOOOOXXYYYYYYYYYYY
XXXXYYYZZZZZZZZZZZZZZZYXXXXXXXXYYYZZZZZZZZZYYYYYYYYYYYYYYYYYYYYZZZZZYYYXXXXOOOOOXYYYYYYYYYYY
XXXXXYYZZZZZYZZZZZZZZZYXXXXXXXXYYYZZZZZZZZZYYYYYYYYYYYYYYYYYYYYYYZZYYYYYXXXXOOOOXYYYYYYYYYYY
YXXXXYYYZZZYYYYZZZZZZZYXXXXXXXXYYYYZZZZZZZYYYYYYYYYYYYYYYYYYYYYYYYYYYYYYXXXXXOOOXYYYYYYYYYYY
YXXXXYYYZZYYYYYYZZZZZZYYXXXXXXXYYYYYZZZZZZYYYYYYYYYYYYYYYYYYYYYYYYYYYYYYYXXXXXOOOYYYYYYYYYYY
YYXXXYYYYYYYYYYYZZZZZZYYXXXXXXYYYYYYYYYYYYYYYYYYYYYYYYYYYYYYYYYYYYYYYYYYYYYXXXXOOOYYYYYYYYYY
YYYYXXYYYYYXXXYYYZZZZZZYYXXXXXYYYYYYYYYYYYYYYYYYYYYYYYYZZZYYYYYYYYYYYYYYYYYYXXXXOOOYYZZYYYYX
ZYYYYYYYYYXXXXXYYYZZZZYYYXXXXYYYYYYYYYYYYYYYYYYYYXXXXYYYYYYYYYYYYYYYYYYYYYYYYXXXXOOOZZZZYYYY
ZZYYYYYYYYYXXXXYYYYZZZYYYXXXYYYZZYYYYYYYYYYYYYYYXXXXXXXYYYYXXXYYYYYYYYYYYYZYYYYYYYOOFZZZYYYY
ZZZYYYYYYYYXXXXXYYYYYYYYYXXYYYZZZZZYYYYYYYYYYYYXXXXXXXXXXXXXXXXXYYYYYYYYYZZZYYYYYZZFFFZZYYYY
Z1Z123334YYXXXXXYYYYYYYYYXXYYYZZZZZYYYXXYYYYYYYXXXXXXXXXXXXXXXXXYYYXYYYYYZZZZYYYZZZZFZZZYYYY
Z1Z12Y3Y4YYYXXXXXYYYYYYYYYYYYYZZZZZZYYXXXYYYYYYXXXXXXXXXXXXXXXXYYYYXXYYYYZZZZZZZZZZZZZZZYYYY
Z111223Y4YYYYXXXXYYYYYYYYYYYYYZZZZZZYYXXXXYYYYYXXXXXXXXXXXXXXXXYYYYXXYYYYZZZZZZZZZZZZZZZYYYY
ZZZZZZYYYYYYYYXXXXXXXYYYYYYYYYZZZZZZYYXXXXYYYYYXXXXXXXXXXXXXXXXYYYYXXXYYYZZZZZZZZZZZZZZZYYYY