----------------------------------
XXXXXXXXXXPPPPPPPPPXXXXXXXXXXXXXXXXXXXXXXXXXXXXXXXXXXXXXXXXXX
XXXXXXXXXXXPPPPPPPXXXXXXXXXXXXXXXXXXXXXXXXXXXXXXXXXXXXXXXXXXX
XXXXXXXXXXXXPPPPPXXXXXXXXXXXXXXXXXXXXXXXXXXXXXXXXXXXXXXXXXXXX
XXXXXXXXXXXXXPPPXXXXXXXXXXXXXXXXXXXXXXXXXXXXXXXXXXXXXXXXXXXXX
XXXXXXXXXXXXXXPXOOXXXXXXXXXXXXXXXXXXXXXXXXXXXXXXXXXXXXXXXXXXX
XXXXXXXXXXXXXXOOOOOOOXXXXXXXXXXXXXXXXXXXXXXXXXXXXXXXXXXXXXXXX
XXXXXXXXXXXXXXOOOOOOOOXXXXXXXXXXXXXXXXXXXXXXXXXXXXXXXXXXXXXXX
XXXXXXXXXXXXOOOOOOOOOOOXXXXXXXXXXXXXXXXXXXXXXXXXXXXXXXXXXXXXX
XXXXXXXXXXX7OOOOOOOOOOOOXXXXXXXXXXXXXXXXXXXXXXXXXXXXXXXXXXXXX
XXXXXXXXXXOO7OOOOOOOOOOOOXXXXXXXXXXXXXXXXXXXXXXXXXXXXXXXXXXXX
XXXXXXXXXOOOO7OOOOOOOOOOFFXXXXXXXXXXXXXXXXXXXXXXXXXXXXXXXXXXX
XXXXXXXXOOOOOO7OXXOOOOOFFSOXXXXXXXXXXXXXXXXXXXXXXXXXXXXXXXXXX
XXXXXXXXOOOOOOXXXXXXXOFFSOOOXXXXXXXXXXXXXXXXXXXXXXXXXXXXXXXXX
XXXXXXXXOOOOOOXXXXXXXXFSOOOOOXXXXXXXXXXXXXXXXXXXXXXXXXXXXXXXX
XXXXXXXOOOOOOOXXXXXXXXXOOOOOOOXXXXXXXXXXXXXXXXXXXXXXXXXXXXXXX
XXXXXXXOOOOOOOOXXXXXXXXXOOOOOOOXXXXXXXXXXXXXXXXXXXXXXXXXXXXXX
XXXXXXXXOOOOOOXXXXXXXXXXXOOOOOOOXXXXXXXXXXXXXXXXXXXXXXXXXXXXX
XXXXXXXXXOOOOOXXXXXXXXXXXXOOOOOOOXXXXXXXXXXXXXXXXXXXXXXXXXXXX
XXXXXXXXXXOO66OXXXXXXXXXXXXOOOOOOOXXXXXXXXXXXXXXXXXXXXXXXXXXX
XXXXXXXXXXX6666XXXXXXXXXXXXXOOOOOOOXXXXXXXXXXXXXXXXXXXXXXXXXX
XXXXXXXXXX6OOOO6XXXXXXXXXXXXXOOOOOOOXXXXXXXXXXXXXXXXXXXXXXXXX
XXXXXXXXXXXOOOOOXXXXXXXXXXXXXXOOOOOOOXXXXXXXXXXXXXXXXXXXXXXXX
XXXXXXXXXXXXOOOOOXXXXXXXXXXXXXXOOOOOOOXXXXXXXXXXXXXXXXXXXXXXX
XXXXXXXXXXXXXOOOOOXXXXXXXXXXXXXXOOOOOOOXXXXXXXXXXXXXXXXXXXXXX
XXXXXXXXXXXXXXOOOOOXXXXXXXXXXXXXXOOOOOOOXXXXXXXXXXXXXXXXXXXXX
XXXXXXXXXXXXXXXOOOOOXXXXXXXXXXXXXXOOOOOOOXXXXXXXXXXXXXXXXXXXX
XXXXXXXXXXXXXXXOOOOOOXXXXXXXXXXXXXXOOOOOOOXXXXXXXXXXXXXXXXXXX
XXXXXXXXXXXXXXXXOOOOXXXXXXXXXXXXXXXX11O1111XXXXXXXXXXXXXXXXXX
XXXXXXXXXXXXXXXXOOOOOXXXXXXXXOOXXXXXX1O11OOOXXXXXXXXXXXXXXXXX
XXXXXXXXXXXXXXXXOOOOOOXXXXXXXOOOOOOXXXOOOOOOOXXXXXXXXXXXXXXXX
XXXXXXXXXXXXXXXXXOOOOOXXXXXXXOOOOOOOOXX11OOOOOXXXXXXXXXXXXXXX
XXXXXXXXXXXXXXXXXOOOOOOXXXXXX4OOOOOOOOXX111OOOOXXXXXXXXXXXXXX
XXXXXXXXXXXXXXXXXXOOOOXXXXXXX44OOOOOOOOXXOOOOOOOXXXXXXXXXXXXX
XXXXXXXXXXXXXXXXXXXOO55XXXXXXO44OOOOOOOOXXOOOOOOOXXXXXXXXXXXX
XXXXXXXXXXXXXXXXXXXO5555OOXXXOO44OOOXOOOOXXOOOOOOOXXXXXXXXXXX
XXXXXXXXXXXXXXXXXXXX555OOOOOXOOO4XXXXOOOOOXXOOOOOOOXXXXXXXXXX
XXXXXXXXXXXXXXXXXXXXX5OOOOOOOOOOOXXXXXOOOOOXXOOOOOOOXXXXXXXXX
XXXXXXXXXXXXXXXXXXXXXXOOOOOOOOOOOXXXXXXOOOOXXXOOOOOOOXXXXXXXX
XXXXXXXXXXXXXXXXXXXXXXXOOOOOOOOOOOXXXXXOOOOXXXXOOOOOOXXXXXXXX
XXXXXXXXXXXXXXXXXXXXXXXXXOOOOOOOOOXXXXXO3OOXXXXOOOOOOXXXXXXXX
XXXXXXXXXXXXXXXXXXXXXXXXXXOOOOOOOOXXXXX3333OXXXOOOOOOOXXXXXXX
XXXXXXXXXXXXXXXXXXXXXXXXXXXXOXOOOXXXXXXX3333XXXXOOOOOOXXXXXXX
XXXXXXXXXXXXXXXXXXXXXXXXXXXXXXXXXXXXXXXOO33OXXXOOOOOOOOXXXXXX
XXXXXXXXXXXXXXXXXXXXXXXXXXXXXXXXXXXXXXXOOOOXXXOOOOOOOOOXXXXXX
XXXXXXXXXXXXXXXXXXXXXXXXXXXXXXXXXXXXXXXXOOOOX22OOOOOOOOOXXXXX
XXXXXXXXXXXXXXXXXXXXXXXXXXXXXXXXXXXXXXXXOOOOO222OOOOOOOOXXXXX
XXXXXXXXXXXXXXXXXXXXXXXXXXXXXXXXXXXXXXXXXOOOOO22OOOOOOOXXXXXX
XXXXXXXXXXXXXXXXXXXXXXXXXXXXXXXXXXXXXXXXXXOOOOO22OOOXOXXXXXXX
XXXXXXXXXXXXXXXXXXXXXXXXXXXXXXXXXXXXXXXXXXXOOOOO222XXXXXXXXXX
XXXXXXXXXXXXXXXXXXXXXXXXXXXXXXXXXXXXXXXXXXXXOOOOO2XXXXXXXXXXX
XXXXXXXXXXXXXXXXXXXXXXXXXXXXXXXXXXXXXXXXXXXXXXXOXXXXXXXXXXXXX
XXXXXXXXXXXXXXXXXXXXXXXXXXXXXXXXXXXXXXXXXXXXXXXXXXXXXXXXXXXXX
XXXXXXXXXXXXXXXXXXXXXXXXXXXXXXXXXXXXXXXXXXXXXXXXXXXXXXXXXXXXX
XXXXXXXXXXXXXXXXXXXXXXXXXXXXXXXXXXXXXXXXXXXXXXXXXXXXXXXXXXXXX
XXXXXXXXXXXXXXXXXXXXXXXXXXXXXXXXXXXXXXXXXXXXXXXXXXXXXXXXXXXXX
XXXXXXXXXXXXXXXXXXXXXXXXXXXXXXXXXXXXXXXXXXXXXXXXXXXXXXXXXXXXX
XXXXXXXXXXXXXXXXXXXXXXXXXXXXXXXXXXXXXXXXXXXXXXXXXXXXXXXXXXXXX
XXXXXXXXXXXXXXXXXXXXXXXXXXXXXXXXXXXXXXXXXXXXXXXXXXXXXXXXXXXXX
XXXXXXXXXXXXXXXXXXXXXXXXXXXXXXXXXXXXXXXXXXXXXXXXXXXXXXXXXXXXX
XXXXXXXXXXXXXXXXXXXXXXXXXXXXXXXXXXXXXXXXXXXXXXXXXXXXXXXXXXXXX
XXXXXXXXXXXXXXXXXXXXXXXXXXXXXXXXXXXXXXXXXXXXXXXXXXXXXXXXXXXXX
