----------------------------------
XXXXXXXXXXPPPPPPPPPXXXXXXXXXXXXXXXXXXXXXXXXXXXXXXXXXXXXXXXXXX
XXXXXXXXXXXPPPPPPPXXXXXXXXXXXXXXXXXXXXXXXXXXXXXXXXXXXXXXXXXXX
XXXXXXXXXXXXPPPPPXXXXXXXXXXXXXXXXXXXXXXXXXXXXXXXXXXXXXXXXXXXX
XXXXXXXXXXXXXPPPXXXXXXXXXXXXXXXXXXXXXXXXXXXXXXXXXXXXXXXXXXXXX
XXXXXXXXXXXXXXPOOOXOXXXXXXXXXXXXXXXXXXXXXXXXXXXXXXXXXXXXXXXXX
XXXXXXXXXXXXXXOOOOOOOXXXXXXXXXXXXXXXXXXXXXXXXXXXXXXXXXXXXXXXX
XXXXXXXXXXXXXOOOOOOOOOXXXXXXXXXXXXXXXXXXXXXXXXXXXXXXXXXXXXXXX
XXXXXXXXXXXXOOOOOOOOOOOXXXXXXXXXXXXXXXXXXXXXXXXXXXXXXXXXXXXXX
XXXXXXXXXXX7OOOOOOOOOOOOXXXXXXXXXXXXXXXXXXXXXXXXXXXXXXXXXXXXX
XXXXXXXXXXOO7OOOOOOOOOOOOXXXXXXXXXXXXXXXXXXXXXXXXXXXXXXXXXXXX
XXXXXXXXXOOOO7OOOOOOOOOOFFXXXXXXXXXXXXXXXXXXXXXXXXXXXXXXXXXXX
XXXXXXXXOOOOOO7XXXOXOOOFFSOXXXXXXXXXXXXXXXXXXXXXXXXXXXXXXXXXX
XXXXXXXXOOOOOOXXXXXXXOFFSOOOXXXXXXXXXXXXXXXXXXXXXXXXXXXXXXXXX
XXXXXXXXOOOOOOXXXXXXXXFSOOOOOXXXXXXXXXXXXXXXXXXXXXXXXXXXXXXXX
XXXXXXXOOOOOOOXXXXXXXXXOOOOOOOXXXXXXXXXXXXXXXXXXXXXXXXXXXXXXX
XXXXXXXOOOOOOOOXXXXXXXXXOOOOOOOXXXXXXXXXXXXXXXXXXXXXXXXXXXXXX
XXXXXXXXOOOOOOXXXXXXXXXXXOOOOOOOXXXXXXXXXXXXXXXXXXXXXXXXXXXXX
XXXXXXXXXOOOOOXXXXXXXXXXXXOOOOOOOXXXXXXXXXXXXXXXXXXXXXXXXXXXX
XXXXXXXXXXOO66OXXXXXXXXXXXXOOOOOOOXXXXXXXXXXXXXXXXXXXXXXXXXXX
XXXXXXXXXXX6666XXXXXXXXXXXXXOOOOOOOXXXXXXXXXXXXXXXXXXXXXXXXXX
XXXXXXXXXX6OOOO6XXXXXXXXXXXXXOOOOOOOXXXXXXXXXXXXXXXXXXXXXXXXX
XXXXXXXXXXXOOOOOXXXXXXXXXXXXXXOOOOOOOXXXXXXXXXXXXXXXXXXXXXXXX
XXXXXXXXXXXXOOOOOXXXXXXXXXXXXXXOOOOOOOXXXXXXXXXXXXXXXXXXXXXXX
XXXXXXXXXXXXXOOOOOXXXXXXXXXXXXXXOOOOOOOXXXXXXXXXXXXXXXXXXXXXX
XXXXXXXXXXXXXXOOOOOXXXXXXXXXXXXXXOOOOOOOXXXXXXXXXXXXXXXXXXXXX
XXXXXXXXXXXXXXXOOOOOXXXXXXXXXXXXXXOOOOOOOXXXXXXXXXXXXXXXXXXXX
XXXXXXXXXXXXXXXOOOOOOXXXXXXXXXXXXXXOOOOOOOXXXXXXXXXXXXXXXXXXX
XXXXXXXXXXXXXXXXOOOOXXXXXXXXXXXXXXXX11O1111XXXXXXXXXXXXXXXXXX
XXXXXXXXXXXXXXXXOOOOOXXXXXXXXOOXXOXXX1O11OOOXXXXXXXXXXXXXXXXX
XXXXXXXXXXXXXXXXOOOOOOXXXXXXXOOOOOOOXXOOOOOOOXXXXXXXXXXXXXXXX
XXXXXXXXXXXXXXXXXOOOOOXXXXXXXOOOOOOOOXX11OOOOOXXXXXXXXXXXXXXX
XXXXXXXXXXXXXXXXXOOOOOOXXXXXX4OOOOOOOOXX111OOOOXXXXXXXXXXXXXX
XXXXXXXXXXXXXXXXXXOOOOXXXXXXX44OOOOOOOOXXOOOOOOOXXXXXXXXXXXXX
XXXXXXXXXXXXXXXXXXXOO55XOXXXXO44OOOOOOOOXXOOOOOOOXXXXXXXXXXXX
XXXXXXXXXXXXXXXXXXXO5555OOXXXOO44OXXXOOOOXXOOOOOOOXXXXXXXXXXX
XXXXXXXXXXXXXXXXXXXX555OOOOOOOOO4XXXXOOOOOXXOOOOOOOXXXXXXXXXX
XXXXXXXXXXXXXXXXXXXXX5OOOOOOOOOOOXXXXXOOOOOXXOOOOOOOXXXXXXXXX
XXXXXXXXXXXXXXXXXXXXXXOOOOOOOOOOOXXXXXXOOOOXXXOOOOOOOXXXXXXXX
XXXXXXXXXXXXXXXXXXXXXXXXOOOOOOOOOOXXXXXOOOOXXXXOOOOOOXXXXXXXX
XXXXXXXXXXXXXXXXXXXXXXXXXOOOOOOOOOXXXXXO3OOXXXXOOOOOOXXXXXXXX
XXXXXXXXXXXXXXXXXXXXXXXXXXXOXOOOOOXXXXX3333OXXXOOOOOOOXXXXXXX
XXXXXXXXXXXXXXXXXXXXXXXXXXXXXXXXXXXXXXXX3333XXXXOOOOOOXXXXXXX
XXXXXXXXXXXXXXXXXXXXXXXXXXXXXXXXXXXXXXXOO33OXXOOOOOOOOOXXXXXX
XXXXXXXXXXXXXXXXXXXXXXXXXXXXXXXXXXXXXXXOOOOXXXOOOOOOOOOXXXXXX
XXXXXXXXXXXXXXXXXXXXXXXXXXXXXXXXXXXXXXXXOOOOX22OOOOOOOOOXXXXX
XXXXXXXXXXXXXXXXXXXXXXXXXXXXXXXXXXXXXXXXOOOOO222OOOOOOOOXXXXX
XXXXXXXXXXXXXXXXXXXXXXXXXXXXXXXXXXXXXXXXXOOOOO22OOOOOOOXXXXXX
XXXXXXXXXXXXXXXXXXXXXXXXXXXXXXXXXXXXXXXXXXOOOOO22OOOXXXXXXXXX
XXXXXXXXXXXXXXXXXXXXXXXXXXXXXXXXXXXXXXXXXXXOOOOO222XXXXXXXXXX
XXXXXXXXXXXXXXXXXXXXXXXXXXXXXXXXXXXXXXXXXXXXOOOOOXXXXXXXXXXXX
XXXXXXXXXXXXXXXXXXXXXXXXXXXXXXXXXXXXXXXXXXXXXXXXXXXXXXXXXXXXX
XXXXXXXXXXXXXXXXXXXXXXXXXXXXXXXXXXXXXXXXXXXXXXXXXXXXXXXXXXXXX
XXXXXXXXXXXXXXXXXXXXXXXXXXXXXXXXXXXXXXXXXXXXXXXXXXXXXXXXXXXXX
XXXXXXXXXXXXXXXXXXXXXXXXXXXXXXXXXXXXXXXXXXXXXXXXXXXXXXXXXXXXX
XXXXXXXXXXXXXXXXXXXXXXXXXXXXXXXXXXXXXXXXXXXXXXXXXXXXXXXXXXXXX
XXXXXXXXXXXXXXXXXXXXXXXXXXXXXXXXXXXXXXXXXXXXXXXXXXXXXXXXXXXXX
XXXXXXXXXXXXXXXXXXXXXXXXXXXXXXXXXXXXXXXXXXXXXXXXXXXXXXXXXXXXX
XXXXXXXXXXXXXXXXXXXXXXXXXXXXXXXXXXXXXXXXXXXXXXXXXXXXXXXXXXXXX
XXXXXXXXXXXXXXXXXXXXXXXXXXXXXXXXXXXXXXXXXXXXXXXXXXXXXXXXXXXXX
XXXXXXXXXXXXXXXXXXXXXXXXXXXXXXXXXXXXXXXXXXXXXXXXXXXXXXXXXXXXX
XXXXXXXXXXXXXXXXXXXXXXXXXXXXXXXXXXXXXXXXXXXXXXXXXXXXXXXXXXXXX
