YYYYYYYYYYYYYYZZZZZZZYYXXXXXYYYZZZZYZZZZZZZ
YYYYYYYYYYYYYYZZZZZZYYXXXXXXYYYZZZZYZZZZZZZ
YYYYZZZZYYYYYYYZZZZZYXXXXXXYYYYYZZYYOSOSOZZ
YYYYZZZZZZYYYYYYYYZYXXXXXXYYYYNLNLOOOOSOOYZ
YYYYZZZZZZYYYYYXXYYXXXO11OOOOOONLOOOOSOSOYY
YYYYZZZZZYYYXXXXXOOONLNO11OONOOOOOOOOOSOOYY
YYYYZZZZZYYXXXXXXOOOLNLO11ONLNOOOOOOOSOSOYY
YYYYZZZZYYYXXXXXXOOONLNO11NLNLZZYYXXXXXXXYY
YYYYZZZZYYYXXXXXXOOOOOOXXYZZZZZZZYXXXXXXXYY
ZZYYZZZZZYYYXXXXXXOOOOOOXYZZZZZZZYYXXXXXXYY
ZZYYZZZZZZYYYYYYYYYYOOOOOYYZZZZZZZYXXXXXXYY
ZZYYZZZZZZZZYYYYYYYYXOOO22YZZZZZZZZYXXXXXXX
ZZYYYZZZZZZZZYYYYYYYXXLN22ONZZZZZZZYXXXXXXX
ZYYYYZZZZZZZZZYYYYYYXXXL2OOLNZZZZZZYXXXXXXX
YYYYYYZZZZZZZZYYYYYYXXXXOOONLNZZZZZYXXXXXXX
YYYYYYYZZZZZZYYYYYYYXXXXXOOOOOOZZZZYXXXXXXX
YYYYYYYYYYZZYYYYYYYYXXXXXXOOOOOOZZZYXXXXXXX
YYYYYYYYYYYYYYYYYYYYYXXXXYYOOOOOOZYYXXXXXYY
XXXXXXXXXXXXXYYYZZZZYYYYYYYYOOOO3OYYYYYYYZZ
XXXXXXXXXXXXXYYYZZZZZZYYYYYYYOOO33OYYYYZZZZ
XXXXXXXXXXXXXYYZLO44OOOOONLOOOOO33OOYZZZZZZ
XXXXOOOOOOOOOONLOO44OOOOOOOOOOOON3OOZZZZZZZ
YYXOOFOOOONOOOOOOO44ONOOOOOOOOONLNOOZZZZZZZ
ZYYOFFFOONLNOOOOOO44NLNOOOOOOONXXYYZZZZZZZZ
ZZZOOFOONLNLOOOOYYYYYYYYYYZYXXXXXX1Z123334Y
ZZZZZZZZZZYYYYYYYYXXYYYYZZZZYYXXXX1Y12Z3Z4Y
ZZZZZZZZZZZZYYYYYXXXXXYYZZZZZYYYYX111223Z4Y
ZZZZZZZZZZZZYYYYYXXXXXYYYZZZZZYYYYXYYYYYYYY
