ZZZZYXXXXXYYYYYYYXXYYYYYYYYYYYYYXXXXXXXXYYYYZZZZZZZZZZZZZZ
ZZZZYXXXXXYYYYYYYXYYYYYYYYYYYYYYXXXXXXXXYYYYZZZZZZZZZZZZZY
ZZZZYXXXXXYYYYYYYXYYYZZYYYYXXXXYXXXXXXXXOSOSOZZZZZZZZZZZZY
ZZZZYXXXXXYYYYYYYXYYZZZYYYXXXXXYXXOOOOOOOOSOOZZZZZZZZZZZYY
ZZZYYXXXXXYYYYYYYXYYZZZZYYXXXXXYYOOOOOOOOSOSOZZZZZZZZZYYYY
ZYYYYXXXXXYYYYYYYYYZZZZZYYXXXXXYYOOOOOOOOOSOOYZZZZZZZYYYYY
YYYYYXXXXXYYYYYYYYYZZZZZYYXXXXXYYOOOOOOOOSOSOYZZZZZZYYYYYY
YYYYXXXXXXYYYYYYYYYZZZZZYYXXXXYYOOOOYYYYYYYYYYYZZZZZYYYYYY
XXXXXXXXXYYZYYYYYYYZZZZZYYXXXXYYNOOOYYYYYYYYYXYYZZZZZYYYYY
XXXXXXXXXYZZZYYYYOYZZZZZYYXXXYYNLOOOZZZZYYYYXXXYYZZZZYYYYY
XXXXXXXXXYZZZYYYOOOOOOOZYXXXXYYLNOOZZZZZZYYYXXXYYZZZZYYYYY
XXXXXXXXXYZZZYYOOOOOOOO11OOOOYOOOOOZZZZZZYYYXXXYYZZZZYYYYY
XXXXXXXXXYZZZYYOOOOOONO11OOOOOOOOOZZZZZZZYYYXXXYYYZZZZYYYY
XXXXXXXXYYZZZZYOOOOONLN11OOOOOOOOOZZZZZZZYYYXXXYYYZZZYYYYY
XXXXXXXXYYZZZYYOOOOYZZZ11OOOOOOOOZZZZZZZZYYYXXXYYYZZZYYYYY
XXXXXXXXYYZZZYYOOOOYZZZYYXXXXOOOOZZZZZZZZYYYXXXYYYZZZYYYYY
YYXXXXXXYYZZZYYOOOOYZZZZYXXXXXYZZZZZZZZZYYYYYOXYYZZZZYYYYY
YYYYXXXXYYYYYYYOOOOZZZZZYXXXXXXYZYYYYYYYYYYYOFOOYZZZYYYXXX
ZZYYYYXXXYYYYYYOOOOZZZZZYXXXXXXYYYYYYYYYYYYYFFFOOOZYYYXXXX
ZZZZYYYYYYYYYYYNOOOZZZZZYYXXXXXXYXXXXXYYYYYZOFOOOOOYYYYXXX
ZZZZZYYYYXXXXYYLOOOZZZZZYYXXXXXXXXXXXXXYYYZZZOOOOOOOOYYYYY
ZZZZZZYYYXXXXXXOOOOZZZZZYYXXXXXXXXXXXXXYYYZZZZZOOOOOOOYYYY
ZZZZZZZYYXXXXXXOOOOZZZZZYYXXXXXXXXXXXXXYYYZZZZZZOOOOOOYYYY
ZZZZZZZYYXXXXXXOOOOZZZZZYYYXXXXXXXXXXXXXYZZZZZZZZZOOOOYYYZ
ZZZZZZZZYXXXXXXOOOOZZZZYYYYYYXXXXXXXXXXXYZZZZZZZZZOOOOYYZZ
ZZZZZZZZYYXXXXXOOOOZZZZYYYYYYYXXXXXXXXXYYZZZZZZZZZOOOOYYZZ
ZZZZZZZZYYXXXXOOOOZZZZZYYYYYYYYXXXXXXXXYYZZZZZZZZYNOOOYZZZ
ZZZZZZZZZYXXXXOOOOZZZZYYYYZZZYYYXXXXXXXYYZZZZZZZYYLNOOYZZZ
ZZZZZZZZZYYXXX2222YYYYYYYYZZZZYYXXXXXXXYYZZZZZZYYYYLOOOZZZ
ZZYYZZZZZZYXXX2222YYYYYYYZZZZZZYXXXXXXYYZZZZZZYYYXXOOOOZZZ
YYYYZZZZZZYXXXOOOOYYYYYYYZZZZZZYYOLNXXYYZZZZZYYXXXXOOOOZZZ
YYYYYZZZZZYXXXOOOOYYYYYYYYZZZZZYOONLNXYYZZZZZYYYXXOOOOOZZY
YYYYYYZZZYYXXXOOOOZYYYYYXYZZZZZOOOOOOOOZZZZZZYYYXOOOOOYYYY
XXXXYYZZZYYXXXOOOOZYYYYXXYYZZZOOOOOOOOOOZZZZZYYYOOOOOYYYYY
XXXXYYYYYYYXXXOOOOZYYYYXXXYYZOOOOOOOOOOOOOZZZYYOOOOOYYYYYY
XXXXYYYYYYYYOOOOOOZZYYYXXXYYYOOOOOXXOOOOOOOOZY5OOOOYYYYYYY
XXXXYYYYYYYOOOOOOOZZYYYXXXYYOOOOOXXXXXOOOOOOO555OOYYYYYYYX
XXXXYYYYYYOOOOOOYZZYYYYXXXY44OOOXXXXXXYOOOOOOO555YYYYYYYXX
XXYXYYYYOOOOOOOYYZZYYYYXXXO444OYXXXXXXYZZOOOONLNYYYYYYYXXX
YYYYYYYOOOOOOOYYYZZYYYYYXOOO44YYXXXXXXYZZZOOOLNYYYYYYYXXXX
YYYYYYOOOOOOYYYYYYYYYYYYOOOOOYYYXXXXXXYZZZZZONYYYYYYYYXXXX
YYYYOOOOOOOYYYYYYYYYYYYOOOOOOYYYXXXXXXYYZZZZZYYYYYYYYYXXXX
YYYYOOOOOOYYYYYYYYYYYYOOOONLZZZYYXXXXXYYZZZZYYYYYYYYYXXXXX
YYYOOOOOOO3ZZZYYYYYYYYOOOOLZZZZZYYXXXXYYYYYYYXXXXXXXYXXXXX
YYYYOOOOO33OOZZYYYYYZOOOOOZZZZZZZYXXXXXYYYYYXXXXXXXXXXXXXX
YYYXYYOOO33OOOOZYYYZOOOOOZZZZZZZZYYXXXXYYYYXXXXXXXXXXXXXXX
YYXXYYYZ333OOOOLNLYOOOOOZZZZZZZZZYYYXXXYYYXXXXXXXXXXXXXXXX
YYXXYYYZZZOOOOONLNOOOOOZZZZZZZZZZZYYYXXYXXXXXXXXXXXXXXXXXX
YYXXYYZZZZZZOOOOOOOOOOOZZZZZZZZZZZYYYYYXXXXXXXXXXXXXXXXXXX
YYXXYYZZZZZZZZYOOOOOOOZZZZZZZZZZZZYYYYYXXXXXXXXXXXYXXXXXXX
YYYXYYZZZZZZZYYYYOOOOZZZZZZZZZZZZZYYYYYYXXXXXXXXY1Y123334X
YYYYYYZZZZZZYYYYYYZZZZZZZYYYYYZZZZYYYYYYXXXXXXXYY1Y12X3X4X
YYYYYZZZZZZYYYYYYYYZZZZZZYYYYYYYYYYYYYYYXXXXXXYYZ111223X4X
YYYYYZZZZZYYYXXXYYYZZZZZYYYXXXYYYYYYYYYYYXXYYYYZZZZZYYXXXX
