YYYYYYYYYXXXXXXXYYYYYYYYXXXXXYYYYYYXXXXXXXXXXYYYYZZZZZZZZZYYYYYYYYYY
YYYYYYYYYYYXXXXYYYYYYYYYYYYYYYYYYYYYYXXXXXXXXYYYYYZZZZZZZZYYYYYYYYYY
ZZYYYYYYYYYYXXXYYYYYYYYYYYYYYYYYYYYYYYYXXXXXXYYYYYYZZZZZZZYYYYYYYYYY
ZZZZYYYYYYYOOOYYYYYYYYYYYYYYYYYYYYYYYYYYYYYYYYYYYYYYYZZZZZYYYYYYYYYY
ZZZZZYYYYYOOFOOYYYYYYYYYYYYYYYYYYYYYYYYYYYYYYYXYYYYYYYYYZZYYYYYYYYYY
ZZZZZZYYYYOFFFOOYYYYYYYYYYYYYYYYYZYYYYYYYYYYYYXYYYYYYYYYYYYYYYYYYYYY
ZZZZZZYYYYOOFOOOOYYYYYYYYYYYYYYYZZZYYYYYYYYYYYXXYYYYYYYYYYYYYZZZZZYY
ZZZZZZYYYYYOOOOOOOYYYYYYYYYYYYYYZZZZYYYYYYYYYYXXYYYYYYYYYYYYYZZZZZZZ
ZZZZZZYYYYYXOOOOOOOYYYYYYYYYYYYYZZZZZZYYYYYYYYXXXXYYYYYYYYYYYZZZZZZZ
ZZZZZYYYYYXXXOOOOOOOYYYYYYYYYYYYYZZZZZZZYYYYYYXXXXXXXYYYYYYYYZZZZZZZ
ZZZZYYYYYXXXXXOOOOOOOYYYYYYYYYYYYYZZZZZZZYYYYYYXXXXXXXXXYYYYYYZZZZZZ
ZZZYYYYYXXXXXXXOOOOOOOYYYYYYYYYYYYZZZZZZZZYYYYYXXXXXXXXXXYYYYYYZZZZZ
ZYYYYYYYXXXXXXXXOOOOOOYYYYYYYYYYYYYZZZZZZZZYYYYYXXXXXXXXXXYYYYYZZZZZ
YYYYYYYXXXXXXXXOOOOOOOYXXXXXYYYYYYYZZZZZZZZZYYYYXXXXXXXXXXXYYYYYZZZZ
YYYYYYYXXXXXXXOOOOOOOYYYYYYYYYYYYYYYZZZZZZZZZYYYXXXXXXXXXXXXYYYYYZZZ
YYYYYYYXXXXXXOOOOOOOYYYYYYYYYYYYYYYYZZZZZZZZZZYYYXXXXXXXXXXXYYYYYZZZ
YYYYYYYXXXXXOOOOOOOZYYYYYYYYYYXXXYYYZZZZZZZZZZYYYYXXXXXXXXXXYYYYYYZZ
YYYYYYYXXXXOOOOOOOZZZYYYYYYYYYXXXYYYZZZZZZZZZZZYYYYXXXXXXXXXYYYYYYZZ
YYYYYYYYXXOOOOOONYZZZZYYYYYYYYXXXYYYZZZZZZZZZZZYYYYYXXXXXXXXXYYYYYYZ
YYYYYYYYXXOOOOONYZZZZZZYYYYYYYXXXYYYZZZZZZZZZZZYYYYYXXXXXXXXXYYYYYYZ
YYYYYYYYXXOOOONLNZZZZZZYYYYYYYXXXYYYZZZZZZZZZZZYYYYYYXXXXXXXXYYYYYYY
YYYYYYYYXXXOOOONLNZZZZZYYYYYYYYXXYYYZZZZZZZZZZZYYYYYYYXXXXXXXYYYYYYY
YYYYYYYXXXXXOOOONOOZZZZYYYYYYYYXXYYYZZZZZZZZZZZYYYYYYYXXXXXXXYYYYYYY
YYYYYYYXXXXXXOOOOOOOZZYYYYYYYYYYXYYYZZZZZZZZZZZYYYYYYYYXXXXXYYYYYYYY
YYYYYYYXXXXXXXOOOOOOOYYYYYYYYYYYYYYYZZZZZZZZZZYYYYYYYYYYYYYYYYYYYYYY
YYYYYYYXXXXXXXXOOOOOOOYYYYYYYYYYYYYZZZZZZZZZZZYYYYYYYYYYYYYYYYYYYYYY
ZYYYYYXXXXXXXXXXOOOOOOYYYYYYYYYYYYYZZZZZZZZZZYYYYYYYYYYYYYYYYYYYYYYY
ZZYYYYXXXXXXXXXXOOOOOOYYYYYYYYYYYYZZZZZZZZZZZYYYYYYYYYYYYYYYYYYYYYYY
ZZZYYYYXXXXXXXXOOOOOOOYYYYYYYYYYYZZZZZZZZZZZZYYYYYYYYYYYYYYYYYYYYYYY
ZZZYYYYXXXXXXXLNOOOOOXXYYYYYYYYZZZZZZZZZZZZZZZYYYYYYYYYYYYYYYYYYYYYY
ZZZYYYYXXXXXXLN66OOOXXXXYYYYYYZZZZZZZZZZZZZZZZYYYYYYYYYXXXXYYYYYYYYY
ZZZYYYYXXXXXONO666OXXXXXYYYYYYZZZZZZZZZZZZZZZZYYYYYYYYXXXXXXYYYYYYYY
ZZZYYYYXXXXOOOOO66XXXXXXXOOOOZZZZZZZZZZZZZZZZZYYYYYYYXXXXXXXYYYYYYYY
ZZZYYYYYXXOOOOOOOXXXXXXXOOOOOOZZZZZZZZZZZZZZZZYYYYYYXXXXXXXXXYYYYYYY
ZZYYYYYYXXOOOOOOOXXXXXXOOONLNLOZZZZZZZZZZZZZZZYYYYYYXXXXXXXXYYYYYYYY
ZZYYYYYYYXXOOOOOOOXXXXOOOOLNLNOOZZZZZZZZZZZZZZYYYYYXXXXXXXXXYYYYYYYY
YYYYYYYYYYXXOOOOOONXXOOOOONLNLOOOZZZZZZZZZZZZZYYYYYXXXXXXXXXYYYYYYYY
YYYYYYYYYYYYXOOOONLNLNOOOOLNLNOOOOZZZZZZZZZZZYYYYYXXXXXXXXXYYYYYYYYY
YYYYYYYYYYYYYYOOOONLNOOOOOYYOOOOOOOZZZZZZZZZZYYYYYXXXXXXXXXYYYYYYYYZ
YYYYYYYYYYYYYYYOOOONOOOOOYYYYO55OOOOZZZZZZZZYYYYYXXXXXXXXXXYYYYYYYZZ
YYYYYYYYYYYYYYYYOOOOOOOOYYYYYY555OOOYZZZZZZZYYYYYXXXXXXXXYYYYYYZZZZZ
YYYYYYYYYYYYYYYYYOOOOOOYYYXXXXO555OOYYZZZZZYYYYYYYYYYYYYYYYYYZZZZZZZ
YYYYYYYYYYYYYYZZZZOOOOYYYYXXXOOO555OYYYYYZYYYYYYYYYYYYYYYYYZZZZZZZZZ
YYYYYXYYYYYYYZZZZZZOZYYYYYXXOOOOO55YYYYYYYYYYYYYYYYYYYYYYYZZZZZZZZZZ
YYYYXXYYYYYYYZZZZZZZZYYYYXXOOOOOOOXXYYYYYYYYYYYYYYYYYYYYYZZZZZZZZZZZ
YYYYXXYYYYYYYZZZZZZZZYYYYXOOOOOOOXXXYYYYYYYYYYYYYYYYYYYYZZZZZZZZZZZZ
YYYYXXYYYYYYYZZZZZZZZYYYYOOOOOOOXXXXYYYOOOOYYYYYYYYYYNOOOZZZZZZZZZZZ
YYYYXXYYYYYYYZZZZZZZZYYYOOOOOOOXXXXXXYOOOOOOYYYYYYYYNLOOOOZZZZZZZZZZ
YYYYYXYYYYYYYYZZZZZZZYYYOOOOOOOXXXXXYOOOOOOOOYYYYYYNLNOOOOOZZZZZZZZZ
YYYYYXYYYYYYYYYZZZZZYYYYXOOOOOOOXXXXLOOOOOOOOOYYYYOOOOOOOOOOZZZZZZZZ
YYYYYYYYYYYYYYYYYZZZYYYXXXOOOOOOOXXLNOOOOOOOOOOYYOOOOOOOOOOOOZZZZZZZ
YYYYYYYYYYYYYYYYYYYYYYXXXXXOOOOOOOOOOOOOOOOOOO444OOOOOOOOOOOOOZZZZZZ
YYYYYYYYYYYYYYYYYYYYYXXXXXXXOOOOOOOOOOOOYYOON444OOOOOOYYOOOOOOOZZZZZ
YYYYYYYYYYYYXXYYYYYYXXXXXXXXXOOOOOOOOOOYYYYNLN4OOOOOOYYYYOOOOOOOZZZZ
YYYYYYYXXXXXXXXXXXXXXXXXXXXXXXOOOOOOOOYYYYYYNLNOOOOOXXXXYYOOOOOOZZZZ
YYYYYYXXXXXXXXXXXXXXXXXXXXXXXXXOOOOOOYYYYYYYYNOOOOOXXXXXXYOOOOOOOZZZ
YYYYYXXXXXXXXXXXXXXXXXXXXXXXXXYYOOOOZZZYYYYYYXOOOOXXXXXXXOOOOOOOZZZY
YYYYYXXXXXXXXXXXXXXXXXXXXXXXXXYYYOOZZZZZYYYYYXXOOXXXXXXXOOOOOOOYYYYY
YYYYYXXXXXXXXXXXXXXXXXXXXXXXXXYYZZZZZZZZZYYYYXXXXXXXXXXOOOOOOOYYYYYY
YYYYYXXXXXXXXXXXXXXXXXXXXXXXXXYYZZZZZZZZZYYYYXXXXXXXXXOOOOOOOYYYYYYY
YYYYYXXXXXXXXXXXXXXXXXXXXXXXXXYYZZZZZZZZZYYYYXXXXXXXXOOOOOOOYYYYYYYY
YYYYYXXXXXXXXXXXXXXXXXXXXXXXXXYYZZZZZZZZZZYYYXXXXXXXXOOOOOOYYYYYYYYY
YYYYYXXXXXXXXXXXXXXXXXXXXXXXXXYYYZZZZZZZZZYYYYXXXXXXXOOOO33YYYYYYYYY
YYYYYXXXXXXXXXXXXXXXXXXXXXXXXXYYYZZZZZZZZZZYYYXXXXXXXOOO333OYYYYYYYY
YYYYYYXXXXXXXXXXXXXXXXXXXXXXXXXYYYZZZZZZZZZZYYXXXXXXXXO333OOOYYYYYYY
YYYYYYYXXXXXXXXXXXXXXXXXXXXXXXXYYYZZZZZZZZZZYYYXXXXXXXX33OOOOOYYYYYY
YYYYYYYYYXXXXXXYYYYYXXXXXXXXXXXXYYYZZZZZZZZZZYYYXXXXXXXXOOOOOOOYYYYY
YYYYYYYYYYYYYYYYYYOOOXXXXXXXXXXXOOOZZZZZZZZZZYOOOOXXXXXXXOOOOOOOYYYY
ZZZYYYYYYYYYYYYYYOOOOOXXXXXXXXXOOOOOZZZZZZZZZOOOOOOXXXXXXXOOOOOOYYYY
ZZZZZZYYYYYYYYYYOOOOOOOXXXXXXXOOOOOOOZZZZZZZOOOOOOOOXXXXXXOOOOOOOYYY
ZZZZZZYYYYYYYYY1OOOOOOOOXXXXXOOOOOOOOOZZZZZOOOOOOOOOOXXXXLNOOOOOXXYY
ZZZZZZZYYYYYYY111OOOOOOOOXXXOOOOOOOOOOOZZZOOOONLNLOOOOXXLNLNOOOXXXYY
ZZZZZZZYYYYYYOO111NOOOOOOOXOOOOOOOOOOOONZNOOOOLNLNOOOOOONLNOOOXXXXXY
YZZZZZZYYYYYOOOO1NLYOOOOOOOOOOOOOXOOOONLNLNOOONYYLOOOOOOONOOOXXXXXXX
YYZZZZZYYYYOOOOONLYYXOOOOOOOOOOOXXYOOOONLNOOOOZYYXOOOOOOOOOOXXXXXXXX
YYYZZZZYYYOOOOOOOYYYXXOOOOOOOOOXXXYYOOOON22OOZYYYXXOOOOOOOOXXXXXXXXX
YYYYYZYYYYOOOOOOYYYYXXXOOOOOOOXXXYYYZOOOOO22ZZYYYXXXOOOOOOXXXXXXXXXX
YYYYYYYYYYOOOOOOOYYYXXXXOOOOOXXXXYYYZZOOOOOZZZYYYXXXXOOOOXXXXXXXXXXX
YYYYYYYYYYYOOOOOOOYYXXXXXOOOXXXXXYYZZZZOOOZZZYYYXXXXXXOOXXXXXXXXXXXX
YYYYYYYYYYYYOOOOOOOYYXXXXXXXXXXYYYYZZZZZZZZZZYYYXXXXXXXXXXXXYYYYXXXX
XXXXXXXXXYYYYOONOOOOYYYXXXXXXXXYYYYZZZZZZZZZYYYYXXXXXXXXXXYYYYYYYYYY
XXXXOOSSOXXYYYNLNOOOOYYYYXXXXXXXYYYYZZZZZZZYYYYYXXXXXXXYYYYYZYYYYYYY
XXXOOSSOOXXYYYYNLNOOOOYYYYYYXXXXYYYYYYYZZYYYYYYYYYYYYYYYYYYZZZYYYYYY
XXXOSSOOOXXYYYYYNOOOOOYYYYYYYXXXXYYYYYYYYYYYYYYYYYYYYYYYYYZZZZZZYYYY
XXXSSOOOOOXYYYYNOOOOOOZYYYYYYYXXXYYYYYYYYYYYYYYYYYYYYYYYZZZZZZZZZYYY
XXXOOOOOOOOYYYOOOOOOOZZYYYYYYYYXXXYYYYYYYYYYYYYYYYYYYYZZZZZZZZZZZYYY
XXXXXOOOOOOOYOOOOOOOZZZYYYYYYYYXXXXXYYYYYYYYYYYYYYYYYZZZZZZZZZZZZYYY
XXXXXXOOOOOOOOOOOOOZZZZZYYYYYYYYXXXXXXXXXXXXXYYYYYYYZZZZZZZZZZZZYYYY
XXXXXXXOOOOOOOONOOZZZZZYYYYYYYYYXXXXXXXXXXXXXXYYYYYZZZZZZZZZZZZYYYYY
XXXXXXXXOOOOOONLNZZZZZZYYYYYYYYYYXXXXXXXXXXXXXYYYYZZZZZZZZZZZZYYYYYY
XXXXXXXXXOOOONLNZZZZZZYYYYYYYYYYYXXXXXXXXXXXXXYYYYZZZZZZZZZZZYYYYYYY
XXXXXXXYYYOOOONYYYYYYYYYYYYYYYYYYYXXXXXXXXXXXXYYYZZZZZZZZZZZYYYYYXXX
YYYYYYYYYYYOOOYYYYYYYYYYYYYYYYYYYYXXXXXXXXXXXXYYYZZZZZZZZZZYYYXXXXXX
YYYYYYYYYYYYYYYYYYYYYYYYYYYYYYYYYYYXXXXXXXXXXXYYYZZZZZZZZZY1Y123334X
YYYYYYYYYYYYYYYYYYXXXXYYYYYYYYYYYYYYXXXXXXXXXXXYYYYZZZZZZZY1Y12X3X4X
YYYYYYYYYYYYYYYYYXXXXXXXYYYYYYYYZZYYYYXXXXXXXXXYYYYYZZZZZYY111223X4X
YYYYYYYYYYYYYYYYXXXXXXXXXYYYYYYZZZYYYYYXXXXXXXXXYYYYYYYYYYYYYXXXXXXX
