YYYYYYYYXXXXXYZZZZYYYYYYYYYYYYYYYYYYXXXXXYYZZZZZZZYYYXXXXXYYYYXXXXXXYYZZZZZYYXXXYZZZYYXYYYYYYYYXXX
YYYYYYYYXXXXXYZZZZYYYYYYYYYYYYYYYYYYYXXXXYYZZZZZZZYYYXXXXXXXXXXXXXXXXYYZZZZZYYXYYZZZYYXXXXYYYYXXXX
YYYZZZYYXXXXXYZZZZZYYXXYYYYYYYYYZZZYYXXXXYYYZZZZZZYYYXXXXXXXXXXXXXXXXYYZZZZZYYYYYZZZYYXXXXXYYYXXXX
YYYZZZZYYXXXXYZZZZZYXXXXYYYYYYYZZZZYYXXXXXYYYZZZZZYYYYXXXXXXXXXXXXXXXYYYZZZZYYYYYZZZYYXXXXXYYYXXXX
YYYZZZZYYXXXXYZZZZZYXXXXYYYYYYYZZZZYYXXXXXYYYZZZZYYYYYXXXXXXXXXXXXXXXYYYYZZZYYYYYZZZZYXOOOOOYYXXXX
YYYZZZZYYXXXYYZZZZYYXXXXYYYYYYYZZZZYYYYXXYXYYYZZYYYYYYYYYXXYYYXXXXXYYYYYYYZZYYYYYZOOOOOOOOOOOYXXXX
YYYZZZYYYXXXYYZZZZYXXXXXYYYYYYYZZZZYYYYYYYXXXYYYYYYYYYYYYYYYYYYYYYYYYYYYYYYYYYOSOSOOOOOOOOOOOYYYYY
YYYZZZYYXXXXYYZZZZYXXXXXYYYYYYZZZZZYYYYYYYXXXXYYYXXYYYYYYYYYYYYYYYYYYYYXXXYYYYOOSOOOOOOOOOOOOYYYYY
YYYYYYYXXXXXYYZZZYYXXXXXYYYYYYYZZZZYYYYYYYXXXXXXXXXXYYYZZZZZZZZZZZZZZZYYYYYYYYOSOSOOOOOOOOOOOYYYYY
XXYYYYXXXXXXYYYYYYXXXXXXYYYYYYYZZZZYYZZZZYYXXXXXXXXXXYZZZZZZZZZZZZZZZZYYYYYYYYOOSOOOOOOXOOOOOOYYYY
XXYYXXXXXXXXYYYYYYXXXXXXXXXXXYYZZZZZZZZZZZYXXXXXXXXXXYZZZZZZZZZZZZZZZZZYYYYYYYOSOSOYYYXXXOOOOOXYYY
XXXXXXXXXXXXYYYYYXXXXXXXXXXXXXYYZZZZZZZZZZYXXXXXXXXXXYZZZZZZZZZZZZZZZZZYYYYYYYXXXXXYYYXXXOOOOOXXYZ
XXXXXXXXXXXYYYYXXXXXXXXXXXXXXXYYZZZZZZZZZZYXXXXXXXXXXYZZZZZZZZZZZZZZZZZYYYYYYYYXXXXXXXXYYOOOOOXXYY
XXYXXXXXXXYYYYXXXXXXXXXXYXXXXYYYYZZYZZZZZYYYXXXXXXXXXYZZZZZZYYYZZZZZZZZYYYYYYYYYXXXXXXYYYOOOOOXXYY
XYYYYXXXYYYYYYXXXXXXXXXYYYYYYYYYYYYYYZZZYYYYXXYYYYYYYYZZZZZYYYYYZZZZZZYYYYYYYYYYXXXXXXYYOOOOOOOXXY
YYYYYYYYYYYYYYXXXXYYYYYYYYYYYYYYYYYYYYYYYYYYXYYYYYYYYYZZZYYXXXXYYZZZYYYYYYYYZZZYYXXXOOOOOOOOOOOXXY
YYYYYYYYYZZZYYXXXYYYYYYYYYYYYYYYYYYYYYYYYYXXXXYYYYYYYYZZZYYXXXXYYYYYYXXXXXXYYZZYYOOOOOOOOOOOOOOXXY
XYYYYYYYZZZZZYYXYYYZZZZZZZYYYYYYYYYYYYYYYXXXXXXYYYYYYZZZZYYXXXXYYYYYXXXXXXXXYYYYOOOOOOOOOOOOOOXXXY
XYYYYYYYZZZZZYYYYYZZZZZZZZZYYYYYYYYYYYYYYXXXXXXXYYYYYZZZZYYXXXXXYXXXXXXOOOOXYYYYOOOOOOOOOOOOOYYXYY
XYYYYYYYZZZZZYYYYYZZZZZZZZZZYYYYYYYYYYYYYXXXXXXXYYYYYZZZZYYYXXXXXXOOOOOOOOOXXYYYOOOOOOOOZZZZYYYYYY
XYYYYYYYZZZZZYYYYYZZZZZZZZZZYYYYYYYYYZZYYXXXXXXXYYYYYZZZZYYYYXOOOOOOOOOOOOOOXYYYYOOOOOZZZZZZYYYYYY
XYYYYYYYZZZZZYYYYYZYYYYZZZZYYYYYYYYYYZZYYXXXXXXXYYYYYZZZZYYYYOOOOOOOOOOOOOOOXYYYYOOOOOZZZZZZYYYYYY
XYYYYYYYZZZZZYYYYYZYYYYYZZYYYYYYYYYYZZZZYXXXXXXYYYYYYZZZZYYYYOOOOOOOOOOOOOOOYYYYYOOOO1ZYYYYYYYYYYY
YYYYYYYYZZZZYYYYYYYYXXXYYYYYYYYYYYYYZZZZYYXXXXXYYYYYYZZZZYYYYO22222OOOOOOOOOYYYYY111111YYYYYYYYYYY
YYYYYYYYZZZZYYYYYYYXXXXXYYYYYYYYYYYYYZZZYYXXXXYYYYYYYZZZZYYYY22222OYYYYOOOOOYYYYYY111OOXXXXYYYYYYY
YYYYYYYZZZZZZYYYYYYYXXXXYYYYYYYYYYYXYYZZYXXXXXYYYYYYZZZZZYYYY2OOOOYYYYYYOOOOOZZZYZOOOOOXXXXXXYYYYY
YZZYYYZZZZZZZYYYYYYYXXXXYYYYYYYYYYXXYYYYYXXXXYYYYYYZZZZZZYYYYYOOOOOYYZYYOOOOOZZZOOOOOOOXXXXXXXYYYY
YZZZYZZZZZZZZYYYYYYYYXXXYYYYYZZYYXXXXYYYYXXXXYYYYYYZZZZZZYYYYYOOOOOYYZYYOOOOOOOOOOOOOOOXXXXXXXXYYY
ZZZZYZZZZZZZZYYYYYYYYYXXYYYYYZZYYXXXXYYYYXXXYYZYYYYZZZZZZYYYYYOOOOOYZZYYOOOOOOOOOOOOOOOXXXXXXXXXYY
ZZZYYYZZZZZZZYYYYYYYYYYYYYYYYZYYYXXXXYYYYXXYYYYYYYYZZZZZZYYYYYOOOOOYZZYYYOOOOOOOOOOOOOOXXXXXXXXXYY
ZZYYYYYZZZZZZYYYYYYYYYYYYYYYYYYYXXXXYYYYYYYYYYYYYYYYZZZZZYYYYYOOOOOOYYYYYOOOOOOOOOOOOYXXXXXXXXXXYY
YZYYXYYZZZZZZYYYYYYYYYYYYYYYYYYYXXXXYYYYYYYYYYYYYXYYZZZZZYYOOOOOOOOOYYYXXOOOOOOOOYYYYYYXXXXXXXXXYY
YYXXXXXYZZZZYYYYYYYYYYYYYYYYYYYYXXYYYZZZYYYYYYYYXXXXYYZOOOOOOOOOOOOOYYXXXXOOOZZZYYYYYYYYXXYYYXXXYY
YYXXXXXYYZZZYYYYYYYYYYYYYXXXYYYYXXYYYZZZZYYYYYYXXXXXYYOOOOOOOOOOOOOOYYXXXXXYYZZYYYYYYYYYYYYYYYXXYY
YXXXXXXYYZZYYYYYYYYYYYYXXXXXYYYYXYYYZZZZZYYYYYXXXXXXYOOOOOOOOOOOOOOYYYXXXXXXYYYYYYYYYYZYYYYYYYYYYY
XXXXXXXYYYYYYYYYYYXYYYYXXXXXYYYYYYYYZZZZZZYYXXXXXXXXYOOOOOOOOOOOYYYYYYXXXXXXYYYYYYYYYZZZZYYYYYYYYY
XXXXXXYYYYYYYYYYXXXYYYXXXXXYYYYYYYYYZZZZZZYYXXXXXXXXYYOOOOOXXXXXYYYYYYXXXXXXXYYYYYYYYZZZZZYYYYYYYY
YXXXXXYYYYYYYYYXXXXYYYYXXXXYYYYYYYYYYZZZZYYXXXXXYYYYYYOOOOOXXXXXYYYYYYXXXXXXXYYYYYYYYZZZZZYYYYYYYY
YXXXXXYYYYYYYYYXXXYYYYYXXXYYYYYYYYYYYZZZZYYXXXXYYYYYYYOOOOOXXXXXYYYYYYXXXXXXXYYYYYYYYYZZZZZYYYYYYY
YXXXXXYYYYYYYYYXXXYYYYYYXYYYYYYYYYYYYZZZZYYXXXXYYYYYYYOOOOOXXXXYYYZZYYXXXXXXYYYYYYYYYYZZZZYYYYYYYY
YYYXXYYYYXXYYYYXXYYYYYYYYYYYYYYYYYYYYZZZYYXXXXYYZZZYYYYOOOOOXXXYYZZZYYYXXXYYYYYYYYYYYYYZZZYYYYYYYY
ZYYYYYYYYXXYYYYXXYYYYYYYYYYYYYYYYYYYYZZZYYXXXXYZZZZZYYYOOOOOYYYYZZZZYYYYYYYYYYYYYYYXXXYYYZZYYYYYYY
ZYYYYYYYYXXYYYYXXXXYYYYYYYYYYYYYYYYYYZZZYYXXXYYZZZZYYYYOOOOOYYYZZZZZYXYYYYYZZYYYYYYXXXXYYZZZZYYYYY
YYYYYYYYYYYYYYXXXXXYYYYYYYYYYYYYYYYYZZZZYYYXXYYZZZZOOOOOOOOOYYZZZZZZYXXYYYZZZZZZZYYXXXXYYZZZZZYYYY
YYYYYYYYYYYYYYXXXXXYYYYYYYYYYYYYYYYYZZZZYYYXYYZOOO33OOOOOOOOOZZZZZZZYXXYYZZZZZYZZYYYXXXXYZZZZZYYYY
YYZZZYYYYYYYYYXXXXXYYYYYYYYYYYYYYYYYYYYYYYYXYYOOOO33OOOOOOOOZZZZZZZZYXYYYZZZZYYYZZYYXXXXYZZZZZYYYY
YYZZZZYYYYYYYYXXXXXYYYYYYYYYYYYYYYYYYYYYYYYXYYOOOO33OOOOOOOZYZZZZZZZYXYYYZZZYYYYZZYYXXXXYZZZZYYYYY
YYZZZZYYYYYYYYXXXXXYYYYYYYYYYYYYYYYYYYYYYYYXXYOOOO33OOOOZZZYYYYZZZZZYXYYYZZYYYYYYYYYYXXYYZZZZYYYYY
XYYZZZYYYYYYYYYXXXYYYZZYYYYYYYYYYYYYYYYYYYXXXYOOOOO3YYZZZZYYYYYYZZZZYYYYYYYYXXXYYYYYYYXYYZZZYYYXYY
XYYZZZYYYYYYYYYXXYYYZZZYYYYYYYYYYYYYYYYYYYXXXXOOOOOYYZZZZYYXXXXYYZZZYYYYYYYXXXXXYYYZYYYYZZYYYXXXXY
XXYYYYYYXXXXXYXXXYYYZZZZYYYYYYYYYYYYYXXXXXXXXXYOOOOOYZZZZYYXXXXXYYYYYYYYYYYXXXXXYYZZZYYYYYYYXXXXXY
XXYYYYYXXXXXXXXXYYYYZZZZYYYYXXXYYYYYXXXXXXXXXXYOOOOOZZZZZYXXXXXXXYYYYYYYYXXXXXXXYYZZZZYYYYYXXXXXXY
XXYYYYYXXXXXXXXYYYYYZZZZZYYXXXXYYYYYXXXXXXXXXXYOOOOOZZZZZYXXXXXXXXYYYYYYYXXXXXXYYZZZZZYYYXXXXXXXXY
XXYYYYYXXXXXXXYYYYYYZZZZZYXXXXXYYYYYXXXXXXXXXXYOOOOOZZZZZYXXXXXXXXYYYYYYXXXXXXXYYZZZZZYYYXXXXXXXYY
XXYYYYYXXXXXXXYYYYYYZZZZZYXXXXXYYYYYXXXXXXXXXXYZOOOOOZZZZYXXXXXXXXXYYYYYXXXXXXYYYZZZZZYYXXXXXXYYYY
XXYYYYYXXXXXXYYYYYYYZZZZYYXXXXXYYYYYYYXXXXXXOOOOOOOOOZZZZYXXXXXXXXXYYYYYXXXXXYYYYYZZZZYYXXXXXYYYYY
XXYYYYYXXXXXXYYZZYYYYZZZYXXXXXYYYYYYYYYYOOOOOOOOOOOOOZZZZYXXXXXXXXYYYYYYYYXXYYYYYYYZZYYXXXXXYYYZYY
YYYYZYYYXXXXXYZZZZYYYYYYYXXXXXYZZZYYYYYOOOOOOOOOOOOOOYZZZYYXXXXYYYYYYYYYYYYYYZZYYYYYYYYXXXXXYZZZZY
YYZZZZYYXXXXYYZZZZYYYYYYYXXXXYZZZZZYYYOOOOOOOOOOOOOOYYYYYYYXXXYYYYYYYYYYYYYYZZZZYYYYYYYXXXXYYZZZZY
ZZZZZZZYXXXXYZZZZZYYYZZZYYXXYYZZZZZYYYOOOOOOOOOOOXXXXYYYYYYYYYYZZZZYYYYYYYYZZZZZYYYYYYYXXXXYYZZZYY
ZZZZZZZYYXXYYZZZZYYYZZZZZYYYYYZZZZZYYYZOOOOOXXXXXXXXXXYYYYYYYYZZZZZZZYYYYYZZZZZZYYYYYYXXXXXYYZZYYX
ZZZZZZZYYYYYYZZZYYYYZZZZZYYYYZZZZZYYYYYOOOOOXXXXXXXXXXXYYYYYYZZZZZZZZYYYYYZZZZZZYYYYYYXXXXXYYYYYYX
ZZZZZZZYYYYYYYYYYYYYZZZZZZYYZZZZZZYYYYYOOOOOXXXXXXXXXXXXYYYYZZZZZZZZZYYYYYZZZZZZYYYXXXXXXXXYYYYYYX
ZZZZZZZYYYYYYYYYYYYYZZZZZZZZZZZZZYYYYYYOOOOOYXXXXXXXXXXXYYYYZZZZZZZZZYYYYYYZZZZZYYYXXXYXXXYYYYYYYX
ZZZZZZZYYYYYYYYYYYYYYZZZZZZZZZZYYYYYYYYYOOOOOXXXXOOOOOOYYYYZZZZZZZZZZYYXXYYZZZZZYYXXXXYXXXYYYYYYYY
ZZYYYYYYYYYYYYXXXXYYYYYYYZZZZYYYYYYYYXXYOOOO44OOOOOOOOOYYYYZZZZZZZZZYYXXXXYZZZZZYYXXXXYYYYYYYYYYYY
YYYYYYYYYYYYYYXXXXYYYYYYYYYYYYYYYYYYYXXXOOOO444OOOOOOOOYYYYZZZZYYYYYYYXXXXXYZZZZYXXXXYYYYYYYYYYYYY
YYYYYYYXXYYYYYXXXYYYYYYYXYYYYYYYYYYYYXXXOOOOO44OOOOOOOOOYYYZZZZYYYYYYYXXXXXYYYYYYXXXXYYYYYYYYYYYYY
YXXXYXXXXXYYYYXXXYYZYYYXXXXYYXXXYYYZYXXXOOOOO44OOOOOOOOOYYZZZZYYYYYYYYXXXXXYYYYYXXXXXYYYYYYYYXXXYY
YXXXXXXXXXXYYYYXXYYZZYYXXXXXXXXXYYYZYYXXYOOOO44OOOYOOOOOYYZZZZYYYYYYYXXXXXXXYYYYXXXXXYYYYYYYXXXXXY
YXXXYXXXXXXYYYYXYYYZZYYOXXXXXXXXYYYZYXXXYYOOOZZZZZZOOOOOYYZZZYYYYYZYYXXXXXXXYYYXXXXXYYYYYYYYXXXXXY
YXXYYYXXXXXYYYYXXYYOOOOOOOXXXXXYYYYZYXXXYYYZZZZZZZZOOOOOOYZZYYYYYZZYYXXXXXXXXYXXXXYYYYYYYYYYXXXXXY
YXYYYYYXXXXYYYOOOOOOOOOOOOXXXXXYYYYZYXXXYYYZZZZZZZZYOOOOOYYYYYYYYZZZYYXXXXXXXXXXXYYYYYYYYYYYXXXXXY
YYYYZYYXXXXYOOOOOOOOOOOOOOYYYYYYYYYYYXXXXYYYZZZZZZZYOOOOOYYYYYYYYZZZYYXXXXXYYYYYYYYYYYYYYYYYYXXXXY
YYYZZZZYYYYOOOOOOOOOOOOOOOYYYYYYYYYYXXXXXYYYYYYYZZOOOOOOOYYYYYYYYZZZZYXXXXYYYYYYYYZZZYYYYYYYYXXXYY
YYYZZZZYYYYOOOOOOOOOOOOOOOOYYYYYYYYYXXXXXYYYYYOOOOOOOOOOOXXXXYYYZZZZZYXXXXYYYYYYYYZZZZYZZZZYYYYYYY
YYYZZZZZZYYYOOOOOOOYYZOOOOOYZZZYYYYXXXXXXYYOOOOOOOOOOOOOOXXXXXYYZZZZZYXXXXYYYXXXXYYZZZZZZZZYYYYYYY
YYYZZZZZZYYYOOOOOXXYYYOOO66ZZZZZYYYXXXXXXYYOOOOOOOOOOOOOOXXXXXYYZZZZZYXXXXYYXXXXXYYZZZZZZZZZYYYYYZ
YYYYZZZZZZYYOOOOOXXYYY66666ZZZZZZOOOOXXXXYYOOOOOOOOOOOOXXXXXXXYYZZZZZYYXXXYYXXXXXYYYZZZZZZZZYYYYYZ
YYYYZZZZZZYYOOOOOXXYYY666OOOZOOOOOOOOOXXXYYOOOOOOOOZZZYYXXXXXXYYZZZZZYYXXXYYXXXXXYYYZZZZZZZZYYYYYZ
YYYYYZZZZZYYOOOOOOXYYYYOOOOOOOOOOOOOOOXXXYYOOOOOYZZZZZYYXXXXXXYYZZZZZYYXXXYYXXXXXYYYYZZZZZZZYYYYYZ
ZYYYYYYZZYYYYOOOOOYYYYYOOOOOOOOOOOOOOOXXXYYOOOOOOYZZZYYYYXXXXYYYYZZZYYYYXYYYXXXXYYYYYYZZZZZZYYYYYY
ZYYXXYYYYYYYYOOOOOYYYYYOOOOOOOOOOOOOOOOXXYYYOOOOOYYYYYYYYYYYYYYYYZZZYYYYYYYYXXXXYYYYYYYZZZZZYYYYYY
ZYYXXXXYYYYOOOOOOOYYYXYOOOOOOOOOOZOOOOOXYYYYOOOOOYYYYYYYYYYYYYYYYZZZZYYYYYYYYYYYYYYYYYYZZZZYYYYYYY
ZZYXXXXOOOOOOOOOOOOYYYYYOOOOOYZZZZOOOOOXYYYYOOOOOXXXXYYYZZZZYYYYYZZZZZZZZZZYYYYYZYYYYYYZZZZZYYZZYY
ZZYYOOOOOOOOOOOOOOYYYYYYYYYYYYZZZZOOOOOXYYYYOOO555XXXXYYZZZZYYYYYZZZZZZZZZZZZZZZZZYYYYYZZZZZZZZZZZ
ZZYYOOFOOOOOOOOOOOYYYYYYYYYYYYZZZZOOOOOYYYYO555555XXXXYYZZZZZYYYYZZZZZZZZZZZZZZZZZYYYYYZZZZZZZZZZZ
ZZYYOFFFOOOOOOOOYYYYYYYYYYYYYYZZZZZOOOOOOOOO5555OOXXXXYYZZZZYYYYYZZZZZZZZZZZZZZZZZYYYYYZZZZZZZZZZZ
ZZYYOOFOOOOOXXXXYYYYYYYYYYYYYYZZZZZOOOOOOOOOOOOOOOXXXXYYZZZZYYYYYYZZZZZZZZZZZZZZZZYYYYYZZZZZZZZZZZ
ZZYXXOOXXXXXXXXYYYYYYYYYYYYYYYYZZZZOOOOOOOOOOOOOOXXXXXYYYZZYYYYYYYZZZZZZZZZZZZZZZYYYXYYYYZZYZZZZZZ
YYYXXXXXYYYYXXYYYYYYYYYYYYXXYYYZZZZOOOOOOOOOOOOOXXXXXYYYYYYYYYYYYYZZZZZZZZZYYYYYZYXXXYYYYYYYYZZZZY
YYXXXXXYYYZYYYYYYYYYYYYYYYXXXYYYYYYYOOOOOOOZZZYYXXXYYYYYYYYYXXYYYYYYYYZZZZYYYYYYYXXXXXYYYYYYYZZZYY
YXXXXXYZZZZZZZZZZZZZYYYYYYYYYYYYYYYYXOOXYYZZZZZYYYYYYYYYYXXXXXYYYYYYYYYZZZYYYYYYYXXXXXYYY1Y123334Y
XXXXXYYZZZZZZZZZZZZZZZYYYYYYYYYYYYYYXXXYYZZZZZZYYYYYZYYYXXXXXXYYYYYYYXYYYYYYYYYYYXXXXXXYY1Y12Y3Y4X
XXXXXYZZZZZZZZZZZZZZZZYYYYYYYYYXXXXXXYYYYZZZZZZYYYYYZZYYXXXXXXYYYYYYYXYYYYYYYYYYYXXXXXXYY111223Y4X
XXXXXYZZZZZZZZZZZZZZZZYYYYYYYYYXXXXXYYYYYZZZZZZYYYYYZZYYXXXXXXYYYYYYYXYYYYYYYYYYYXXXXXXYYYYYYYYXXX
