YYYYYYYYYYYYYYYYYYYXXXXXXXXXXXYYYYZZZZZZZZZZYYYYYYYYYYYYYYYYYYYYYYYYYYYYYYYYYYYZZZZZZZZZYYYYYYYYYYYYY
YYYYYYYYYYYYYYYYYYXXXXXXXXXXXXYYYZZZZZZZZZZZYYYYYYYYYYYYYYYYYYYYYYYYYYYYYYYYYYYYYYZZZZYYYYYYYYXXXXXXX
YYYYYYYYYYYYYYYYXXXXXXXXXXXXXYYYYZZZZZZZZZZZYYYYYYYYYYYYYYYYYYYYYYYYYYYYXXXXXYYYYYYYYYYYYYYYXXXXXXXXX
YYYYYYYYYYYYYYYXXXXXXXXXXXXXXYYYZZZZZZZZZZZZZYYYYYYYYYYYYYYYYYYYYYYYYXXXXXXXXXYYYYYYYYYYYYYXXXXXXXXXX
YYYYYYYYYYYYYYOOOOOOOOOOOOOXYYYYZZOONLNLNOOOOOOYYYYYYYOOOOOOOOOOOOOXXXXXXXXXXXXXYYYYYYYYYYYXXXXXXXXXX
YYYYYYYYYYYYYOOOOOOOOOOOOOOOYYYZZOOOONLNOOOOOOOOYYYYYOOOOOOOOOOOOOOOXXXXXXXXXXXXYYYYYYYYYYYXXXXXXXXXX
YYYYYYYYYYYYYOOOOOOOOOOOOOOOYYYZZOOOOONOOOOOOOOOYYYYYOOOOOOOOOOOOOOOXXXXXXXXXXXXXYYYYYYYYYYXXXXXXXXXX
YYYYYYYYYYYYYOOOOOOOOOOOOOOOYYYZZOOOOOOOOOOOOOOOYYYYYOOOOOOOOOOOOOOOXXXXXXXXXXXXXYYYYYYYYYYXXXXXXXXXX
YYYYYYYYYYYYYNOOOOOOOOOOOOOOYYYZZOOOOOOOOOOOOOOOYYYYYOOOOOOOOOOOOOOOXXXXXXXXXXXXYYYYYYYYYYYXXXXXXXXXX
YYYYYYYYYYYYYLNOOOXXXXXOOOOOYYYYZOOOOOZZZZZOOOOOYYYYYOOOOOYYYYYOOOOOXXXXXXXXXXXXYYYYYYYYYYYXXXXXXXXXX
YYYYYYYYYYYYYNLN33XXXXXOOOOOYYYYZOOOOOZZYYYOOOOOYYYYYOOOOOYYYYYOOOOOXXXXXXXXXXXYYYYYYYYYYYYXXXXXXXXXX
YYYYYYYYYYYYYLN333XXXXXOOOOOYYYYYOOOOOYYYYYOOOOOYYYYYOOOOOYYYYYOOOOOXXXXXXXXXYYYYYYYYYYYYYYXXXXXXXXXX
YYYYYYYYYYYYYNOOOOYYYYYOOOOOYYYYYOOOOOYYYYYOOOOOYYYYYOOOOOYYYYYOOOOOXXXXXXXXYYYYYYZZZZYYYYYYXXXXXXXXX
YYYYYYZZZZZZZOOOOOYYYYYOOOOOYYYYYOOOOOYYYYYOOOOOYYYYY2OOOOYYYYYOOOOOXXXXYYYYYYYZZZZZZZZZYYYYXXXXXXXXX
YYYYOOOOOOOOOOOOOOYYYYYNOOOOOOOOOOOOOOYYYYYOOOOOOOOO22OOOOYYYYYOOOOOOOOOOOOOOZZZZZZZZZZZZYYYYXXXXXXXX
YYZOOOOOOOOOOOOOOOYYYYYLNOOOOOOOOOOOOOYYYYYOOOOOOOOO22OOOOYYYYYOOOOOOOOOOOOOOOZZZZZZZZZZZZYYYXXXXXXXX
YZZOOOOOOOOOOOOOOOYYYYYNLNOOOOOOOOOOOOYYYYYOOOOOOOOON2OOOOYYYYYOOOOOOOOOOOOOOOZZZZZZZZZZZZYYYYXXXXXXX
YZZOOOOOOOOOOOOOOOYYYYYLNOOOOOOOOOOOOOYYYYYOOOOOOOONLNOOOOZYYYYOOOOOOOOOOOOOOOZZZZZZZZZZZZZYYYXXXXXXX
ZZZOOOOOOOOOOOOOOYYYYYYYOOOOOOOOOOOOOYYYYYYYOOOOOONLNLNOOZZYYYYYOOOOOOOOOOOOOOZZZZZZZZZZZZZYYYXXXXXXX
ZZZOOOOOZZZZZZZZYYYYYYYYYYYYXXXXXXXXXXYYYYYYZZZZZZZZZZZZZZZZYYYYYYYZZZZZZNOOOOZZZZZZZZZZZZZYYYXXXXXXX
ZZZOOOOOZZZZZZZZYYYYYYYYYYYYXXXXXXXXXXXYYYYYZZZZZZZZZZZZZZZZYYYYYZZZZZZZZLNOOOZZZZZZZZZZZZZYYYXXXXXXX
ZZZOOOOOZZZZZZZZYYYYYYYYYYYYXXXXXXXXXXXXYYYYZZZZZZZZZZZZZZZZYYYYYZZZZZZZZNLNOOZZZZZZZZZZZZZYYYXXXXXXX
YZZOOOOOZZZZZZZZYYYYYYYYYYYYYXXXXXXXXXXXXYYYYZZZZZZZZZZZZZZZYYYYZZZZZZZZZLNOOOZZZZZZZZZZZZZYYYXXXXXXX
YZZOOOOOZZZZZZZZYYYYYYYYYYYYYYXXXXXXXXXXXYYYYZZZZZZZZZZZZZZZYYYYZZZZZZZZZNOOOOZZZZZZZZZZZZYYYYXXXXXXX
YYZOOOOOOOOOOOOOOYYYYYYYOOOOONLNLNOOOXXXXXYYYYZZZZZZZZZZZZZZYYYYOOOOOOOOOOOOOOZZZZZOSOSOOOOOOOOOOXXXX
YYZOOOOOOOOOOOOOOOYYYYYOOOOOOONLNOOOOOXXXXXYYYZZZZZZZZZZZZZZYYYOOOOOOOOOOOOOOOZZZZYOOSOOOOOOOOOOOOXXX
YYYOOOOOOOOOOOOOOOYYYYYOOOOOOO4NOOOOOOXXXXXXYYYYZZZZZZZZZZZYYYYOOOOOOOOOOOOOOOYYYYYOSOSOOOOOOOOOOOXXX
XYYOOOOOOOOOOOOOOOYYYYYOOOOOOO44OOOOOOXXXXXXXYYYYZZZZZZZZZYYYYYOOOOOOOOOOOOOOOYYYYYOOSOOOOOOOOOOOOXXX
XYYYOOOOOOOOOOOOOOYYYYYOOOOOOO44OOOOOOXXXXXXXYYYYYYYYYYYYYYYYYYOOOOOOOOOOOOOOYYYYYYOSOSOOOOOOOOOOOXXX
XYYYZZZZZZZZZOOOOOZZZZZOOOOOZZZZYOOOOOXXXXXXXXYYYYYYYYYYYYYYXXXOOOOOXXXXXXXXXXXXXXXXXXXXXXXXXOOOOOXXX
XYYYZZZZZZZZZOOOOOZZZZZOOOOOZZZZZOOOOOXXXXXXXXXYYYYYYYYYYYXXXXXOOOOOXXXXXXXXXXXXXXXXXXXXXXXXXOOOOOXXX
XXYYZZZZZZZZZOOOOOZZZZZOOOOOZZZZZOOOOOYYXXXXXXXXYYYYYYYYYXXXXXXOOOOOXXXXXXXXXXXXXXXXXXXXXXXXXOOOOOXXX
XXYYZZZZZZZZZOOOOOZZZZZOOOOOZZZZZOOOOOYYYYXXXXXXXXXYYXXXXXXXXXXOOOOOXXXXXXXXXXXXXXXXXXXXXXXXXOOOOOXXX
XXYYYZZZZZZZZOOOOOZZZZZOOOOOZZZZZOOOOOYYYYYXXXXXXXXXXXXXXXXXXXXOOOONXXXXXXXXXXXXXXXXXXXXXXXXXOOOOOXXY
XXYYYZZZZZZZZOOOOOOOOOOOOOOOZZZZZOOOOOOOOOOOOOOXXXXXXXXXXXXXXXX111NLNOOOOOOOOXXXXXXXOOOOONLNLNOOOOXXY
XXYYYZZZZZZZZOOOOOOOOOOOOOOOZZZZZOOOOOOOOOOOOOOOXXXXXXXXXXXXXXX11NLNLNOOOOOOOOXXXXXOOOOOOONLNOOOOOXXY
XXYYYZZZZZZZZOOOONOOOOOOOOOOZZZZZOOOOOOOOOOOOOOOXXXXXXXXXXXXXXXOOONLNOOOOOOOOOXXXXXOOOOOOOONOOOOOOXXY
XYYYYZZZZZZZZOOONLNOOOOOOOOOZZZZZOOOOOOOOOOOOOOOXXXXXXXXXXXXXXXOOOONOOOOOOOOOOXXYYYOOOOOOOOOOOOOOOXXY
XYYYYYZZZZZZZZONLNLNOOOOOOOYYYZZZZOOOOOOOOOOOOOOYYYYYYYYYXXXXXXXOOOOOOOOOOOOOOYYYYYOOOOOOOOOOOOOOXXYY
XYYYYYZZZZZZZZZZYYYYYYYYYYYYYYYYZZZZZZZZZZZOOOOOYYYYYYYYYYYYYYXXXXXXXXXXXOOOOOYYYYYOOOOOYYYYYXXXXXXYY
XYYYYYYYZZZYYYYYYYYYYYYYYYYYYYYYYZZZZZZZZZZOOOOOYYYYYYYYYYYYYYYYXXXXXXXXXOOOOOYZZZZOOOOOYYYYYYYYYYYYY
YYYYYYYYYYYYYYYYYYYYYYYYYYYYYYYYYYYZZZZZZZZOOOOOYYYYYYYYYYYYYYYYYXXXXXXYYOOOOOZZZZZOOOOOZZZYYYYYYYYYY
YYYYYYYYYYYYYYYYYYYYXXXXXXXXXXXXXYYYYZZZZZZOOOOOYYYYYYYYYYYYYYYYYYYYYYYYYOOOOOZZZZZOOOOOZZZZZYYYYYYYY
YYYYYYYYYYYYYYXXXXXXXXXXXXXXXXXXXXYYYYYYYZZOOOOOYYYYYYYYYYYYYYYYYYYYYYYYYOOOOOZZZZZOOOOOZZZZZZZYYYYYY
YYYYYYYYYYXXXXXXXXXXXXXXXXXXXXXXXXOOOOOOOOOOOOOOYYYYYYYYYYYYYYYYYYYYYYYYYOOOOOOOOOOOOOOOZZZZZZZZYYYYY
YYYYYYYYXXXXXXXXXXXXXXXXXXXXXXXXXOOOOOOOOOOOOOOOYYYYYYYYYYYZZZYYYYYYYYYZZOOOOOOOOOOOOOOOZZZZZZZZZYYYY
YYYYYYYXXXXXXXXXXXXXXXXXXXXXXXXXXOOOOOOOOOOOOOOOYYYYYYYYYYZZZZYYYYYYYZZZZOOOOOOOOOOOOOOOZZZZZZZZZZYYY
YYYYYYXXXXXXXXXXXXXXXXXXXXXXXXXXXOOOONOOOOOOOOOOYYYYYYYYYYZZZZZYYYYZZZZZZOOOOOOOOOOOOOOOZZZZZZZZZZZYY
YYYYYXXXXXXXXXXXXXXXXXXXXXXXXXXXXOOONLNOOOOOOOOYYYYYYYYYYYYZZZZZZZZZZZZZZZOOOOOOOOOOOOOZZZZZZZZZZZZYY
YYYYYXXXXXXXXXXXXXXXYYYYYYXXXXXXXOONLNXXXYYYYYYYYYYYYYYYYYYYZZZZZZZZZZZZZZZZZZZZZZZZZZZZZZZZZZZZZZZZY
ZYYYXXXXXXXXXXXXXXYYYYYYYYYYYXXXXOOONLXXXXYYYYYYYYYYYYYYYYYYYYYYYYZZZZZZZZZZZZZZZZZZZZZZZZZZZZZZZZZZZ
ZYYYXXXXXXXXXXXXXYYYYYYYYYYYYYXXXOOOONXXXXXYYYYYYYYYYYYYYYYYYYYYYYYYZZZZZZZZZZZZZZZZZZZZZZZZZZZZZZZZZ
ZYYYXXXXXXXXXXXXYYYYYYYZZYYYYYYYXOOOOOXXXXXYYYYYYYYYYYYYYYYYYYYYYYYYYYYYYYYYZZZZZZZZZZZZZZZZZZZZZZZZZ
ZYYYXXXXXXXXXXXXYYYZZZZZZZZZZYYYYOOOOOXXXXXXYYYYYYYYYYYYYYYYYYYYYYYYYYYYYYYYYYYYYYYYYYYYYYYYZZZZZZZZZ
ZYYYXXXXXXXXXXXYYYYZZZZZOOOOOOOOOOOOOOXXXXXXYYYYYYYYYYYYYYYYYYYYYYYYYYYYYYYYYYYYYYYYYYYYYYYYYZZZZZZZZ
ZZYYYXXXXXXXXXXYYYZZZZZOOOOOOOOOOOOOOOXXXXXXXYYYYYYYYYYYYYYYYYYYYYYYYYYYYYYYYYYYYYYYYYYYYYYYYYZZZZZZZ
ZZYYYXXXXXXXXXXYYYZZZZZOOOOOOOOOOOOOOOYYXXXXXXYYYYYYYYYYYYYYYYYYYYYYYYYYYYYXXXXYYYYYYYYYYYYYYYYZZZZZZ
ZZZYYYXXXXXXXXYYYYZZZZZOOOOOOOOOOOOOOOYYYYXXXXXXXXXXXXXYYYYYYYYYYYYYYYYYYYXXXXXXXXXYYYYYYYYYYYYYYZZZZ
ZZZYYYYXXXXXXXYYYYZZZZZOOOOOOOOOOOOOOYYYYYYXXXXXXXXXXXXXYYYYYYYYYYYYYYYYYYXXXXXXXXXXXXXYYYYYYYYYYYYYY
ZZZYYYYYXXXXXYYYYYZZZZZOOOOOZZZZZZZZZYYYYYYYXXXXXXXXXXXXXYYYYYYYYYYYYYYYYYXXXXXXXXXXXXXXXXXYYYYYYYYYY
ZZZYYYYYYXXXYYYYYYZZZZZOOOOOZZZZZZZZZZYYYYYYXXXXXXXXXXXXXYYYYYYYYZZYYYYYYYXXXXXXXXXXXXXXXXXYYYYYYYYYY
ZZZYYYYYYYYYYYYYYYZZZZZNOOOOZZZZZZZZZZYYYYYYYXXXXXXXXXXXXXYYYYYYZZZZZYYYYYXXXXXXXXXXXXXXXXXYYYYYYYYYY
YZZYYYYYYYYYYYYYYYZZZZZLNOOOZZZZZZZZZZYYYYYYYXXXXXXXXXXXXXYYYYYZZZZZZZYYYYYXXXXXXXXXYYYYYYYYYYYYYYYYY
YYZYYYYYYYYYYYYYYYZZZZZNLN55ZZZZZZZZZZZYYYYYYYXXXXXXXXXXXXYYYYYZZZZZZZZYYYYXXXXXXYYYYYYYYYYYYYYYYYYYY
YYYYYYYYYYYYYYYYYYZZZZZLN5555OOOOOOOOZZYYYYYYYYXXXXXXXXXXXXYYYYZZZZZZZZZYYYYXXYYYYYYYYYYYYYYYYYYYYYYY
YYYYYYYYYYYYYYYYYYYZZZZNOOOOOOOOOOOOOOZZYYYYYYYXXXXXXXXXXXXYYYYZZZZZZZZZZYYYYYYYYYYYYYYYYYYYYYYYYYYYY
YYYYYYYYYYYYYYYYYYYZZZZOOOOOOOOOOOOOOOZZYYYYYYYYXXXXXXXXXXXYYYZZZZZZZZZZZZYYYYYYYYYYYYYYYYYYYYYYYYYYY
YYYYYYYYYYYYYYYYYYYYYZZOOOOOOOOOOOOOOOZZZZYYYYYYYXXXXXXXXXXYYYYZZZZZZZZZZZZYYYYYYYYYYYYYYYYYYYYYYYYYY
YYYYYYYYYYYYYYYYYYYYYYYYOOOOOOOOOOOOOOYZZZZZZZYYYYXXXXXXXXXXYYYZZZZZZZZZZZYYYYYYYYYYYYYYYYYYYYYYYYYYY
YYYYYYYYYYYXYYYYYYYYYYYYYYYYYXXXXOOOOOYZZZZZZZZYYYXXXXXXXXXXYYYYZZZZZZZZZZYYYYYYYYYYYYYYYYYYYYYYYYYYY
YYYYYYYYYXXXXXXYYYYYYYYYYXXXXXXXXOOOOOYZZZZZZZZZYYYXXXXXXXXXXYYYYZZZZZZZZZYYYYYYYYYYYYYYYYYYYYYYYYYYZ
YYYYYYYYYXXXXXXXYYYXXXXXXXXXXXXXXOOOOOYZZZZZZZZZYYYXXXXXXXXXXYYYYZZZZZZZZYYYYYYYYYYYYYYYYYXYYYYYYYYZZ
YYYYYYYYYXXXXXXXXXXXXXXXXXXXXXXXXOOONOZZZZZZZZZZYYYXXXXXXXXXXYYYYYZZZZZZZYYYYYYYYYYYYYYYYXXYYYYYYYZZZ
YYYYYYYYYYXXXXXXXXXXXXXXXXXXXXXXXOONLNZZZZZZZZZZYYYXXXXXXXXXXYYYYYYZZZZZYYYYYYYYYYYYYYYYYXXYYYYYYZZZZ
YYYYYYYYYYYXXXXXXXXXXXXXXXXXXXXXXONLNLNOOOOOOOOZYYYXXXOOOOOOOOO66OOYYZZYYYYYYYYYYYYYYYYYYXXYYYYYYZZZZ
YYYYYYYYYYYYYYYYYXXXXXXXXXXXXXXXXOONLNOOOOOOOOOOYYYXXOOOOOOOOOO66OOOYYYYYYYYYYYYYYYYYYYYYXXYYYYYZZZZZ
YYYYYYYYYYYYYYYYYXXXXXXXXXXXXXXXXOOONOOOOOOOOOOOYYYXXOOOOOOOOOO66OOOYYYYYYYYYYYYYYYYYYYYYYXYYYYYZZZZZ
YYYYYYYYYYYYYYYYYYXXXXXXXXXXXXXXXOOOOOOOOOOOOOOOYYXXXOOOOOOOOOO66OOOYYYYYYYYYYYYYYYYYYYYYYYYYYYZZZZZZ
YYYYYYYYYYYYYYYYYYXXXXXXXXXXXXXXYYOOOOOOOOOOOOOOYXXXXOOOOOOOOOO66OOOYYYYYYYYYYYYYYYYYYYYYYYYYYZZZZZZZ
YYYYYYYYYYYYYYYYYYYXXXXXXXXXXXXYYYZZZZZZZZZOOOOOYXXXXOOOOOXXYYY66OOOYYYYYYYYYYYYYYYYYYYYYYYYYYZZZZZZZ
YYYYYYYYYYYYYYYYYYYYXXXXXXXXXYYYYZZZZZZZZZZOOOOOXXXXXOOOOOXXYYYOOOOOYYYYYYYYYYYYYYYYYYYYYYYYYZZZZZZZZ
YYYYYYYYYYYYYYYYYYYYYYYYYYYYYYYYZZZZZZZZZZZOOOOOXXXXXOOOOOXXYYYOOOOOYYYZZZZZZYYYYYYYYYYYYYYYYYZZZZZZZ
XXXYYYYYYYYYYYZZZZZYYYYYYYYYYYZZZZZZZZZZZZZOOOOOXXXXXOOOOOXXYYYOOOOOZZZZZZZZZZZZZZZYYYYYYYYYYYZZZZZZZ
XXXXXYYYYYYYYZZZZZZZYYYYYYYYYZZZZZZZZZZZZZZOOOOOXXXXXOOOOOXXYYYOOOOOZZZZZZZZZZZZZZZZZYYYYYYYYYYZZZZZZ
XXXXXXYYYYYYZZZZZZZZZZZYYYZZZZZZZZZZZZZZZZZOOOOOOOOOOOOOOOXXXYYOOOOOOOOOOOOOOZZZZZZZOOOOOOOOOOOOOZZZY
XXXXXXXYYYYYZZZZZZZZZZZZZZZZZZZZZZZZZZZZZZZOOOOOOOOOOOOOOOXXXYYOOOOOOOOOOOOOOOZZZZZOOOOOOOOOOOOOOOYYY
XXXXXXXYYYYYZZZZZZZZZZZZZZZZZZZZZZZZZZZZZZZOOOOOOONOOOOOOOXXXYYOOOOOOOOOONOOOOZZZZZOOOOOOOOOOOOOOOYYY
XXXXXXXYYYYYZZZZZZZZZZZZZZZZZZZZZZZZZZZZZZZOOOOOONLNOOOOOOXXXYYOOOOOOOOONLNOOOZZZZZOOOOOOOOOOOOOOOYYY
XXXXXXXYYYYYYZZZZZZZZZZZZZZZZZZZZZZZZZZZZZZYOOOONLNLNOOOOXXXXYYYOOOOOOONLNLNOOZZZZZNOOOOOOOOOOOOOOYYY
XXXXXXXYYYYYYZZZZZZZZZZZZZZZZZZZZZZZZZZZZZZZYYXXXXXXXXXXXXXXYYYYYYYZZZZZZLNOOOZZZZZLNOOOYYYYYOOOOOYYY
YXXXXXXYYYYYYYZZZZZZZZYYYYYZZZZZZZZZZZZZZZZZYYXXXXXXXXXXXXXXYYYYYYYYZZZZZNOOOOZZZZZNLNOOYYYYYOOOOOYYY
YYXXXXXYYYYYYYYZZZZYYYYYYYYYYYZZZZZZZZZZZZZZYYYXXXXXXXXXXXXXYYYYYYYYYZZZZOOOOOZZZZZLNOOOYYYYYOOOOOYYY
YYYYYYYYYYYYYYYYYYYYYYYYYYYYYYYYZZZZZZZZZZZZYYYYXXXXXXXXXXXYYYYYYYYYYYYYYOOOOOZZYYYNOOOOYYYYYOOOOOYYY
YYYYYYYYYYYYYYYYYYYYYYYYYYYYYYYYYZZZZZZZZZZZZYYYYXXXXXXXXXYYYYYYYYYYYYYYYOOOOOYYYYYOOOOOYYYYYOOOOOYYY
ZZYYYYYYYYYYYYYYYYYYYYXXXXXYYYYYYYZZZZZZZZZZYYYYYYXXXXXXXYYYYYYYYYYYYYYYYOOOOOOOOOOOOOOOYYYYYOOOOOYYY
ZZZZYYYYYYYYYYYYYYYYYYYXXXXXYYYYYYYYZZZZZZZYYYYYYYXXXXYYYYYYYZZZZZZZYYYYYOOOOOOOOOOOOOOOYYYYYOOFOOXXX
ZZZZZZYYYYYYYYYYYYYYYYYYXXXXYYYYYYYYYYYYYYYYYYYYYYYYYYYYYYYYZZZZZZZZZZYYYOOOOOOOOOOOOOOOYYYYYOFFFOXXX
ZZZZZZZZYYYYYYYYYYYYYYYYYYYYYYYYYYYYYYYYYYYYYYYYYYYYYYYYYYYZZZZZZZZZZZZYYOOOOOOOOOOOOOOOYYYYYOOFOOXXX
Z1Z123334ZYYYYYYYYYYYYYYYYYYYYYYYYYYYYYYYYYYYYYYYYYYYYYYYYYZZZZZZZZZZZZZYYOOOOOOOOOOOOOYYYYYYYOOOXXXX
Z1Z12Z3Z4ZZYYYYYYYYYYYYYYYYYYYYYYYYYYYYYYYYYYYYYYYYYYYYYYYZZZZZZZZZZZZZZYYYYXXXYYYYYYYYYYYYYYYYXXXXXX
Z111223Z4ZZZYYYYYYYYYYYYYYYYYYYYYYYYYYYYYYYYYYYYYYYYYYYYYYZZZZZZZZZZZZZZYYYYXXXXYYYYYYYYYYYYYYYXXXXXX
ZZZZZZZZZZZZZYYYYYYYYYYYYYYYYYYYXXXXXXXXXXYYYYYYYYYYYYYYYYZZZZZZZZZZZZZZZYYYXXXXXYYYYYYYYYYYYYYXXXXXX
