ZZZZZZZZZYYYXXXXYYZZZZZZZZZZZZ
ZZZZZZZZZZYYYXXXYYYZZZZZZZZZZZ
YYYYZZZZZZZYYYXXXYYYYZZZZYYYYZ
XXXYYYZZZZZZZYYYYYYYYYYYYYYXYY
XXXXYOOOOOZZZZZYYYYYYYYYYYXXXX
XXXXYOOOOO33OZZZZOO77YYYYYXXXX
XXXXYYOOOO33OOOOOO777OOYYYXXXX
XXXYYYOOO33OOOOOOO77OOOOOOYXXX
XXYYFOOOOOZYOOOOOO77OOLOOOOYXX
XXYFFFZOOOYYYOOOOOOOOZZLOOOYXX
XYYOFOOOOOYYOOOOYYOOOYLOOOYYXX
XYYZOOOO4444OOOZZY2222OOOYYYXX
XYYYYOO44OSSOOZZZZY2266OYYYYXX
XYYYYYO4OSSOOZZZZZYOO66XYYYYYY
XXYYYYOOSSOO8ZZZZZOOOOXXXYYYYY
XYYZYYYSSOOO8OOZZOOOOLXXYYYZZZ
YYZZZZOOOO9OOOOOOOOOOOLYYYZZZZ
YYZZZOOOOO99OOOOOOOY1OOYYZZZZZ
YYZZZOOOOO99OZOOOOO111OYYZZZZZ
YYZZZOOOO99O5OOOOOO11OOXYYZZZZ
YYZZZZZYYYYO55OOZZ111OOOXYYZZZ
YYYYYYYYYYYO55LOZZZYOOOXXXYYYY
YYYXYYYYYYZOOLNZZZZYYXXXXXXYXX
YYXXXXXYYYZZOZZZZZZYY1X123334X
YYXXXXXXYYZZZZZZZZYYY1Y12Y3X4X
ZYXXXXXXXYYZZZZZZZYYY111223X4X
ZYYXXXXXXYYZZZZZZYYYZZZZZZYXXX
