YYYZZZZZZZZZZZYYYXXXXXXXXXXX
YYZZZZZZZZZZZZYYXXXXXXXXXXXY
ZZZZZZZZZZZZYYYXXXXXXXXXXXXY
ZZZZZZZZZZZYYYXXXXXXXXXXXXXY
ZZZZZZZZOZYYYXXXOOOXXXXXXXXY
ZZZZZZZOOO5YYXX6OOOOXXXXXXXX
ZZZZZZOOO555XXX66XOOO7XXXXXX
ZZZZZZOOZZ5OOOOOXXXX777XXXXX
ZZZZZ4OZZZYYOOOOXXXXX7OOXXXY
ZZZZ444ZZZZYYOOXXXXXXOOXXXXY
ZZZZOOZZZZZYYYYXXXXXOOOXXXYY
YZZZOOOZZZZYYYYYXXXXOOXXYYYY
YYYYZOOOOYYYYYYYXXXFOYYYYYYZ
YYYYYYYO33YYYYYYYYFFFYYYYZZZ
YYYYYYYY33OYYYYYYYYFYYYYYZZZ
XXXXXXXX33YYYYYYYYYYYYYYZZZZ
XXXXXXXOOXXYYYOYOOOYYYYYYZZZ
XXXXXXXOOXXYYYOOOSSYYYYYYYZZ
XXXXXX2OXXXXYOOOSSOYYYYYYYYY
XXXXX222XXXYOOOSSOYYYYYYYYYY
XXXXX22OXXYYOOSSOYYYYYYXXXXX
YXXXXXOOOOY11ZYYYYYYYYYXXXXX
YXXXXXXXOOO11ZZYYYYYYYYXXXXX
YXXXXXXXXOOOYZZZYYYYYYYYXXXX
YXXXXXXXXXYYYZZZYYY1Y123334X
XXXXXXXXXXXYYZZZZYY1Y12Y3Y4X
XXXXXXXXXXXYYYYYZZZ111223Y4Y
XXXXXXXXXXXXYYYZZZZZZZZZZYYY
