XXXXXYYYYYYZZZ
XXXXXYYYYYZZZZ
XXXXXYYYYYYZZZ
XXXXXYYYYOOOZZ
XXXXXYY2OOSSYZ
XXXXF54OOSSOYZ
XXXFFFOOSSOYYZ
XXXXFXOSSOYYYZ
XXYYY1Y123334Z
YYYYY1Y12Y3Y4Y
ZZZZY111223Y4Y
ZZZZZYYYYXXXXX
