YYYYYYYYYXXXXXXXXXYYYYYYYYYYYYZZZYYYYXXXXXXXYYYYYYYYYYXXXXXXXXYYYZZZYYYYYZZZZZZYYXXXXXXX
YYYYYYYYYYYXXXXXXXYYYYYYYYYYYZZZZZYYYYXXXXXYYYYYYYYYYYXXXXXXXXYYZZZZZYYYYYZZZYYYXXXXXXXY
YYYYZZZZYYYYXXXXXXYYYYYYYYYYYZZZZZZYYYYYYYYYYYYZZZZYYYXXXXXXXYYZZZZZZYYYYYYYYYYYXXXXXXXY
YYZZZZZZZZYYYXXXXXYYYYYYYYYYYYYZZZYYYYYYYYYYYZZZZZZZYYYXXXXXXYYZZZZZZYYYYYZZZYYOOOOOXXYY
YZZZZZZZZZZYYYYYYYYYYYYYYYYXYYYYYYYYYYYYYYYZZZZZZZZZZYYXXXXXYYYZZZZZZYYYYZZOOOOOOFOOXYYY
ZZZZZZZZZZZYYYYYYYYYYYYYYXXXXYYYYYYYYYYYYZZZZZZZZZZZZYYYXXXXYYZZZZZZZYYYOOOOOOOOFFFOOYYZ
ZZZZZZZZZZZZYYYYYYYYYYYYXXXXXXYYYYYYYYYYZZZZZZZZZZZZZYYYYXXYYYZZZZZZYOOOOOOOOOOOOFOOOYYZ
ZZZZZZZZZZZZZZYYYYYYYYYXXXXXXXXYYYYYYYYZZZZZZZZZZZZZZYYYYYYYYYZZZZZYOOOOOOOOOOOOOOOOYYZZ
ZZZZZZZZZZZZZZZZYYYYYYYXXXXXXXXXYYYYYYYZZZZZZZZZZZZZZYYYYYYYYYZZYYYYOOOOOOOOOOOOOOOYYZZZ
ZZZZZZZZZZZZZZZZZYYYYYXXXXXXXXXXXYYYYYZZZZZZZZZZZZZZZYYYYYYYYYYYYYYOOOOOOOOOOOOOZZZZZZZZ
ZZZZZZZZZZZZZZZZZYYYYYYXXXXXXXXXXXYYYYZZZZZZZZZZZZZZZYYYYYYYYYYYYYYOOOOOOOOOZZZZZZZZZZZZ
ZZZZZZZZZZZZZZZZZZYYYYYXXXXXXXXXXXYYYYZZZZZZZZZZZZZZYYYYYYYYYYYYYYOOOOOOOZZZZZZZZZZZZZZZ
ZZZYYYYYYYYZZZZZZZYYYYYYYXXXXXXXXXYYYYZZZZZZZZZZZZZYYYYYYYYYYYYYYYOOOOOOOYZZZZYYZZZZZZZY
YYYYYYYYYYYZZZZZZZYYYYYYYYYYYXXXXXYYYYZZZZZZYYYYYYYYYYYYYYYYYYYYXOOOOOOOYYYYYYYYYZZZZZYY
YYYYYYYYYYYYZZZZZZYYYYYYYYYYYYYXXYYYYYZZZZYYYYYYYYYYYYYYYYYYYYYYXOOOOOOOYYYYYYYYYYYYYYYY
YYYYYYXXXYYYZZZZZZYYYYYYYYYZYYYYYYYYZZZZZYYYYYYYYYYYYYYYYYYYYYYYOOOOOOOYYYYYYYYYYYYYYYYY
YYYYYYXXXXXYYYZZYYYYYYYYYYZZZYYYYOOOOOZZZYYYXXYYYYYYXXXXYYYYYYYYOOOOOOOYYYYYYYXXXYYYYYYX
YYYYYYXXXXXYYYYYYYYYYYYYYOOLZYYYYOOOOOZZYYYYXXXYYYYXXXXXXYYYYYYNLOOOOOYZZYYYYYXXXXXYYYXX
YYYYYYYXXXXYYYYYYYYYYOOOOOONLNYY6OOOOOOZYYYYXXXYYYXXXXXXXXYYYYYLNOOOOOZZZZYYYXXXXXXXXXXX
XYYYYYYYXXXXYYYYYOOOOOOOOO7LNLNNLNLOLOOZYYYYOOXYYYYXXXXXXXYYYYLNOOOOOYZZZZYYYXXXXXXXXXXX
XYYYYYYYYXXXYOOOOOOOOOOOO777OOOLNLNLNLOOYYYOOOOOOOYXXXXXXXYYYYNOOOOOYYZZZZZYYYXXXXXXXXXX
XYYYYYYYYOOOOOOOOOOOOOOO777OOOONLNLNLNLOYYOOOOOOOOOYXXXXXXYYYOOOOOOOYYZZZZZYYYXXXXXXXXXX
XYYYYOOOOOOOOOOOOLOOOO7777OOOOOLNLNLNLNOOOOOOOOOOOOOLXXXXXYYYOOOOOOYYYYZZZZZYYXXXXXXXXXX
XYYYOOOOOOOOOOOOLNLOO777OOOOOOOOOOLNLNOOOOOOOOOOO44LNLNLXXYYOOOOOOOXYYYZZZZZYYYXXYYYYYYY
XYYOOOOOOOOOOOOLNLNLOY7OOOOOOOOOOOOLNOOOOOOOOO444444LNLN88YYOOOOOOXXYYYZZZZZZYYYYYYYYYYY
XYYOOOOOOOOOOOLNLYYYYYYOOOOOOOOOOOOOOOOOOOOOO4444OOOOLN888OOOOOOOOXXXYYZZZZZZZYYYYYYYYYY
XYYYOOOOOOOOOYYYYYYYYYYYOOOOOOOOOOOOOOOOOOOOOOOOOOOOOOO88OOOOOOOOOXXXXYYZZZZZZYYYYYYYYYY
XYYYOOOOOOOOOYYYYYYYYYYYYLNLOOOOOOOOOOOOOOOOOOOOOO33OOO88OOOOOOOOOOXXXYYYZZZZZYYYYYYYYYY
YYYYZOOOOOOOOOYYYYYYYYYYYYLNOOOOOLLOOOOOOOOOOOOOOO33OO88OOOOOOOOOOOXXXYYYYZZZYYYYYYYZZZZ
YYYYZZZOOOOOOOOOYYYYYYYYYYNLOOOOLLNLOOOOOOOOOOOOO33OOO88OOOOOOOOOOOXXXXYYYYYYYYYYYYZZZZZ
YYYYYZZZOOOOOOOLNYYYYYYYYYXNOOOLLNLNLOOOOOOOOOOOO33OOO8ZZOOOOOOOOOOXXXXYYYYYYYYYYYYZZZZZ
YYYYYZZZZOOOOOLNLNYYYYYYYYXXOOLLNLNLNOOOOOOOOOOO333OOOZZZZYOOOOOOOOXXXXYYYYYYYYYYYYZZZZZ
YYYYYYZZZZOOOOOLNLNYYYYYYYXXOOOLLNLNOOOOOOOOOOOO33OOOOOZZZYYYYOOOOXXXXXYYYYYYYYYYYYZZZZZ
YYYYYYYZZZZOOOOOLNOOYYYYYYXXOOOLNLNOOOOOOOOOOOOO33OOOOOZZYYYYYYYYYYYXXXYYYYYYYYYYYYYYZZZ
YYYYYYYYZZZZOOO55OOOOYYYYYOOOOLNLNLOOOOOOOOOOOOOOOLOOOOZYYYYYYYYYYYYYYYYYYYYYYYYYYYYYYYZ
YYYYYYYYYYZYYO55OOOOOOZOOOOOOLNLNLNOOOOOOZOOOOOOOLNLOOOOYYYYYYYYYYYYYYYYYYYYYYYYYYYYYYYY
YYYYYYYYYYYYYY55OOOOOOOOOOOOOOLNLNOOOOZZZOOOOOOOLNLNLOOOYYYYYYYYYYYYYYYYYYYYYYYYYYYYYYYY
YYYYXXXXXYYYXXXOOOOOOOOOOOOOOOOLNOOOYZZZOOOOOOOLNXNLNOOOYYYYYYYYYYYYYYYYYYYYYYYYYYYYYYYY
YYYXXXXXXXXXXXXXXOOOOOOOOOOOOOOOOXXYYZZZOOOOOOOOLNLNOOOOOXXXXXXYYYYYYYYYYYYYYYYYYYYYYYYY
YYXXXXXXXXXXXXXXXYOOOOOOOOOOOOOOYXYYYYZZOOOOOOOOOLNOOOOOOXXXXXXXXYYYYYYYYYYYYYYYYYYYYYYY
YYXXXXXXXXXXXXXXXYYOOOOOOOOOOOOYYYYYYYZZOOOOOOOOOOOOOOOOOXXXXXXXXYYYYYYYYYYYYYYYYYYYYYYY
YYXXXXXXXXXXXXXXXYYZOOOOOOOOOOOOOYYYYYZZZOOOOOOOOOOOOOOOOXXXXXXXXXYYYYYYYYYYYYYYYYYYYYYY
YYXXXXXXXXXXXXXXXYYZZZZZOOOOOOOOOOYYYYZZZZZZOOOOOOOOOOOOOXXXXXXXXXYYYYYYYYYYYYYYYYYYYYYY
YYXXXXXXXXXXXXXXXYYZZZZZZOOOOLOOOOYYYYYZZZZZZZYYOOOOOOOOOXXXXXXXXXYYYYYYYYYYYYYYYYYYYYYY
YYXXXXXXXXXXXXXXXYYZZZZZZOOOLNLOOOOYYYYZZZZZZZYYXXXXOOOOXXXXXXXXXYYYYYYYYYYYYYYYYYYYYYYY
YYXXXXXXXXXXXXXXXYYZZZZZZZZLNLNLOOYYYYYYZZZZZZYYXXXXXXXXXXXXXXXXXYYYYYYYYYYYYYYYYYYYYYYY
YYXXXXXXXXXXXXXXXYYZZZZZZZZNLNLNOOYYYYYYYYZZZYYXXXXXXXXYYYYYXXXYYYYYYYYYYYYYYYYYYYYYYYYY
YYYXXXXXXXYXXXXXXYYYZZZZZZOLNLNOOYYYYYYYYYYYYYYXXXXXXYYYYYYYYYYYYYYYYYYYYYYYYYYYYYYYYYYY
ZYYYYYYYYYYYXXXXXXOOOOOOZOOOLN22YYYYYYYYYYYYYYXXXXXXYYYYZZZYYYYYYYYYYYYYYYYYYYYYYYXXXYYY
YYYYYYYYYYYYYXXXXXOOOOOOOOOOOOO2YYYYYYYYYYYYYXXXXXXYYZZZZZZZZYYZZZZZZZZYYYYYYYYYYYYYYYYY
YYYYYYYYYYZYYYXXXOOOOOOOOOOOOOOYYYZZZYYYYYYXXXXXXXYYYZZZZZZZZZZZZZZZZZZZZZZYYYYYYYYYYYYY
YYYYYYYYZZZYYYXXXOOOOOOOOOOOLOYYYZZZZZYYYYYXXXXXXXYYZZZZZZZZZZZZZZZZZZZZZZZZYYYYYYYYYYYY
YYYYYYZZZZZYYYXXXXOOOOOOOOOLNLYYYZZZZZYYYYXXXXXXXXYYZZZZZZZZZZZZZZZZZZZZZZZZYYYYYYYYYYYY
YYYYYZZZZZZZYYXXXXOOOOOOOOLNLNYYYZZZZZZYYYXXXXXXXYYYZZZZZZZZZZZZZZZZZZZZZZZZYYYYYYYYYYYY
YYYYZZZZZZZZYYXXXXOOOOOOOLNLNLNYYZZZZZZYYYYXXXXXXYYYZZZZZZZZZZZZZZZZZZZZZZZYYYYYYYYYYYYY
YYYYZZZZZZZYYYXXXXOOOOOOOOLNLNOYYZZZZZ1OOOOOOLNLNOYYZZZZZZZZZZZZZZZZZZZZZZYYYYYYYZZZYYYY
YYYYZZZZZZZYYYXXXXXOOOOOOOOLNOOOOOOOOO11OOOOOOLNOOYYZZZZZZZZZZZZZZZZZZZZZYYYYYYYZZZZZYYY
YYYZZZZZZZZYYXXOSOSOOOOOOOOOOOOOOOOOOO11OOOOOOOOOOOYZZZZZZZZZZZYYYYYZZZZYYYYYYYYZZZZZZYY
YYYZZZZZZZYYYXXOOSOOOOOOOOOOOOOOOOOOLO11OOOOOOOOOOOYYZZZZZZZZZYYYYYYYYZYYYYYYYYYZZZZZZYY
YYYZZZZZZZYYXXXOSOSOOOOOOOOOOOOOOOOLNL11OOOOOOOOOOYYYYZZZZZZZYYYYYXYYYYYYYXXYYYYZZZZZZZY
YYYZZZZZZZYYXXXOOSOOOOOOOOOOOOOOOOLNLNL1OOOOOOOOOYYYYYYZZZZZYYYXXXXXXYYYYXXXYYYYZZZZZZYY
YYYZZZZZZZYYXXXOSOSOOOOOOOOOOOOOOLNLNLYYYOOOOOOOOYYYYYYZZZZZYYYXXXXXXYYYYYXYYYYZZZZZZZYY
YYZZZZZZZZYYXXXXXOOOOOOOOOOLOOOOOOLNLNOYOOOOOOOOYYYYYYYZZZZYYYXXXXXXXYYYYYYYYYYZZZZZZZYX
YYZZZZZZZZYYXXXXXXYYYOOOOOLNLOOOOOOLNOOOOOOOOOOYYYYYYYYZZZZYYYXXXXXXXYYYYYYYYYZZZZZZZYYX
YYZZZZZZZZYYXXXXXXYYYYYYOLNLNLOOOOOOOOOOOOOOOOYYYYYYYYYZZZYYYYXXXXXXXYYYYYYYYYZZZZZZZYYX
YYZZZZZZZZYYXXXXXXYYYYZZZYYYLNOOOOOOOOOOOOOOOZYYYYYYYYYYZZYYYYXXXXXXXYYYYYYYYYZZZZZZZYYX
YYZZZZZZZZYYXXXXXXYYYZZZZZYYYYYOOOOOOOOOOOOOZZYYYYYYYYYYZZYYYYXXXXXXXYYYYYYYYYZZZZZZZYYX
YYZZZZZZZZYYXXXXXXYYYZZZZZYYYYYYYYYOOOOOOOOZZZYYYYYYYYYYZZYYYYXXXXXXXYYYYYYYYYZZZZZZZYYX
YYZZZZZZZZYYXXXXXXYYZZZZZZZYYYYYYYYXXYOOOOYZZYYYYYYYYYYYZZYYYYXXXXXXYYYYYYYYYYY1Z123334X
YYYZZZZZZZYYXXXXXXYYZZZZZZZYYYYYYYYYYYYYYYYYYYYYYXXYYYYZZZZYYYYXXXXXYYYYYYYYYYY1Z12Z3Z4Y
YYYZZZZZZZYYXXXXXXYYZZZZZZZYYYYYYYYYYYYYYYYYYYYXXXXYYYYZZZZZYYYYYYYYYYYYYXXYYYY111223Z4Y
YYYZZZZZZZYYXXXXXXYYZZZZZZZYYYYYYYYYYYYYYYYYYYXXXXXXYYYZZZZZYYYYYYYYYYYYYXXXXYYYZZZZZZZY
